,Gene Name,#PE = 1,#PE = 2,#PE = 3,#PE = 4,#PE = 5,Sum of Proteins
2,DAPK2 ,0,0,5,1,0,6
18,NCOA7 ,0,0,3,1,0,4
23,UPK1A ,0,1,0,2,0,3
44,FFAR1 ,0,1,1,0,0,2
54,OPTN ,1,0,0,4,0,5
56,CLDN1 ,0,1,1,0,0,2
67,RNASET2 ,7,0,1,0,0,8
78,IYD ,1,0,0,2,0,3
105,GEMIN2 ,0,0,2,2,0,4
118,MGAT5 ,0,0,3,1,0,4
124,ESR1 ,1,0,3,1,0,5
126,ARL6 ,1,0,2,0,0,3
139,PRMT7 ,0,0,2,1,0,3
149,B3GNT5 ,0,1,1,0,0,2
155,CSN3 ,1,0,1,0,0,2
163,LMCD1 ,6,1,0,0,0,7
176,NIPA2 ,0,1,1,0,0,2
180,CTTN ,5,0,0,1,0,6
195,CTSA ,2,0,1,0,0,3
209,AURKB ,0,1,2,0,0,3
218,IVL ,0,1,0,1,0,2
227,GNAO1 ,2,0,0,1,0,3
242,STXBP2 ,5,1,0,0,0,6
249,SYNPR ,6,0,0,1,0,7
251,KPNA7 ,0,1,3,0,0,4
270,SLC5A4 ,0,1,1,0,0,2
271,RPL14 ,1,0,2,0,0,3
275,IL1B ,1,0,6,0,0,7
285,MED23 ,4,0,1,0,0,5
304,MTHFD2L ,0,0,2,4,0,6
305,PTPRC ,7,0,0,1,0,8
318,MGP ,1,0,1,0,0,2
319,DNAJB6 ,5,0,0,1,0,6
322,HOXC6 ,0,0,1,1,0,2
332,PRDX2 ,4,1,0,0,0,5
335,DDC ,1,1,8,0,0,10
348,PROC ,0,1,0,6,0,7
353,FBN2 ,4,0,2,0,0,6
361,ADGRE3 ,0,0,3,2,0,5
371,SCN7A ,0,0,2,1,0,3
378,WASHC4 ,1,0,0,1,0,2
381,DCP1A ,5,0,2,0,0,7
392,TACC1 ,0,0,8,1,0,9
401,PUDP ,1,0,0,1,0,2
403,SAMD4B ,2,0,0,1,0,3
409,DYNC2H1 ,0,0,2,1,0,3
421,ODF1 ,0,1,0,1,0,2
433,RND3 ,1,1,0,0,0,2
434,KLHL41 ,2,0,4,1,0,7
435,SGMS1 ,0,1,1,1,0,3
439,RASGRP4 ,0,0,5,1,0,6
443,MRPS11 ,1,0,1,0,0,2
446,CARMIL2 ,0,0,2,1,0,3
457,UBE2D2 ,0,1,3,0,0,4
462,ZIC4 ,0,0,3,2,0,5
463,FAS ,0,1,0,7,0,8
481,SNX4 ,0,1,3,0,0,4
482,ATP6V1A ,4,1,0,0,0,5
486,SORD ,1,1,0,0,0,2
492,SGK2 ,0,0,2,1,0,3
506,NPY2R ,0,1,1,0,0,2
507,SMAP1 ,5,0,1,0,0,6
510,SYK ,1,0,4,0,0,5
513,PRRX1 ,0,0,1,1,0,2
526,NRXN1 ,7,0,1,0,0,8
532,GOLM2 ,3,0,2,0,0,5
536,PNMT ,0,1,1,0,0,2
545,TNIK ,0,1,0,5,0,6
558,URM1 ,0,0,1,1,0,2
567,COPB1 ,1,1,0,0,0,2
569,MAN2B2 ,1,0,3,0,0,4
570,POLR3B ,0,0,2,2,0,4
576,FNIP1 ,0,0,1,1,0,2
593,WT1 ,0,1,3,0,0,4
613,GULO ,0,1,1,0,0,2
621,CFP ,3,0,4,0,0,7
637,MOG ,0,0,3,1,0,4
639,MCRIP2 ,0,0,1,1,0,2
643,HMOX1 ,0,1,1,0,0,2
653,KLC2 ,7,0,0,3,0,10
667,REEP1 ,9,0,1,0,0,10
669,GATA2 ,0,1,0,1,0,2
671,RAP2A ,1,1,0,0,0,2
678,RNH1 ,1,0,0,3,0,4
684,BDKRB2 ,0,1,1,0,0,2
688,GRK5 ,0,0,2,1,0,3
690,MTHFD2 ,0,0,2,2,0,4
699,ABCF1 ,0,0,1,1,0,2
700,AMBN ,1,0,2,0,0,3
707,SLC7A5 ,0,1,0,2,0,3
720,TRIM11 ,0,1,0,1,0,2
723,ARAF ,0,1,1,1,0,3
733,DHX16 ,2,0,1,0,0,3
738,VGLL3 ,0,2,0,1,0,3
742,FXYD7 ,3,0,1,0,0,4
744,GAPDH ,1,0,4,0,0,5
745,NTN1 ,0,1,0,6,0,7
746,RAB11A ,3,1,0,0,0,4
756,LOC100517166 ,2,0,3,0,0,5
764,SPPL2B ,0,0,2,1,0,3
771,PAFAH1B1 ,3,1,0,0,0,4
779,NKTR ,0,0,1,6,0,7
783,CHD6 ,0,0,7,1,0,8
785,IL12RB2 ,0,1,3,0,0,4
794,HEBP1 ,0,1,1,0,0,2
797,SPATA24 ,0,1,0,1,0,2
815,CIDEC ,0,1,0,1,0,2
816,BTF3L4 ,2,0,0,1,0,3
821,ZFX ,0,0,1,4,0,5
834,TNNT3 ,0,3,8,0,0,11
847,NMU ,1,0,4,0,0,5
848,LOC110262184 ,0,0,3,1,0,4
864,MAPRE1 ,3,0,0,1,0,4
875,DYNLT4 ,0,1,1,0,0,2
886,FAM135A ,0,0,6,1,0,7
889,MMP20 ,0,1,1,0,0,2
917,TSPAN9 ,1,1,0,0,0,2
919,CYP51A1 ,1,1,0,0,0,2
924,HCST ,1,0,4,0,0,5
928,GAST ,1,0,1,0,0,2
930,DDR1 ,0,0,6,1,0,7
937,FOXO4 ,0,1,0,2,0,3
957,GRIA4 ,0,0,4,2,0,6
963,RUFY2 ,2,0,0,1,0,3
965,HAPLN1 ,0,1,0,1,0,2
977,UBA2 ,1,0,4,1,0,6
978,SLC22A8 ,1,1,1,0,0,3
979,CCN4 ,0,0,2,2,0,4
980,IL17B ,0,1,1,0,0,2
996,TYROBP ,0,1,2,0,0,3
1015,MRPL14 ,2,0,2,0,0,4
1018,PPP2R2A ,0,1,2,1,0,4
1034,TMBIM6 ,0,1,5,0,0,6
1039,SIRT6 ,0,1,0,1,0,2
1069,CRHR1 ,0,0,4,1,0,5
1079,OXSM ,0,0,1,1,0,2
1112,SOS1 ,0,0,3,4,0,7
1116,MFSD6 ,0,1,1,0,0,2
1123,ADSS1 ,0,1,3,0,0,4
1146,HOPX ,2,0,1,1,0,4
1148,DCPS ,1,1,0,0,0,2
1155,GALNT11 ,0,0,3,1,0,4
1156,LDHA ,1,0,5,0,0,6
1157,TNNI2 ,0,1,0,2,0,3
1171,LOC100157711 ,3,0,4,0,0,7
1173,QKI ,0,1,0,2,0,3
1175,SREBF1 ,0,1,0,1,0,2
1180,OLFML2A ,0,0,1,3,0,4
1195,HPD ,5,0,2,0,0,7
1206,SSR2 ,0,0,1,3,0,4
1209,CYSLTR1 ,0,1,0,1,0,2
1215,ASB13 ,1,0,0,3,0,4
1218,BUD23 ,0,0,1,3,0,4
1232,POLR1H ,0,0,1,1,0,2
1235,ABCG4 ,0,0,2,4,0,6
1239,RHBG ,0,1,1,0,0,2
1278,ZFPL1 ,1,0,1,0,0,2
1279,GHSR ,0,1,1,1,0,3
1280,PIK3CG ,1,0,1,0,0,2
1282,MAOB ,3,1,0,0,0,4
1288,KCNN3 ,0,1,0,2,0,3
1297,PITPNM2 ,0,0,2,1,0,3
1301,KLK4 ,0,1,0,1,0,2
1324,SKAP2 ,0,0,3,1,0,4
1326,CD79A ,0,1,0,2,0,3
1335,PPP2R2B ,0,1,6,0,0,7
1338,GALNT17 ,0,0,1,1,0,2
1342,HCRTR1 ,0,1,2,0,0,3
1351,ARNT ,0,2,0,1,0,3
1360,CDK7 ,0,1,5,2,0,8
1374,CNIH1 ,3,0,1,0,0,4
1398,COPS6 ,2,1,0,0,0,3
1416,ARR3 ,0,1,4,0,0,5
1436,UBN2 ,0,0,2,1,0,3
1460,USP37 ,0,0,3,1,0,4
1474,SCARB1 ,6,1,0,0,0,7
1479,RBP4 ,1,0,2,0,0,3
1486,SEPTIN12 ,0,1,1,0,0,2
1487,CD40 ,2,1,0,0,0,3
1496,SPARC ,1,0,3,0,0,4
1497,B4GALT4 ,0,0,1,1,0,2
1505,GATB ,8,0,0,1,0,9
1511,SEMA3E ,0,0,2,1,0,3
1517,C1QTNF7 ,0,1,0,2,0,3
1522,GPR161 ,0,0,2,1,0,3
1534,TESMIN ,0,0,1,1,0,2
1543,YY1 ,0,1,1,0,0,2
1555,DLST ,1,0,3,1,0,5
1570,RPL27A ,3,1,0,0,0,4
1573,FUT8 ,1,0,3,0,0,4
1578,AR ,0,1,4,0,0,5
1586,SMG1 ,0,0,5,1,0,6
1591,FOXL2 ,0,0,1,1,0,2
1617,REST ,0,1,0,5,0,6
1660,PXN ,0,0,1,5,0,6
1670,SAT1 ,0,1,1,0,0,2
1688,AP1AR ,1,0,0,3,0,4
1702,IPO11 ,7,0,0,2,0,9
1703,LIAS ,0,0,5,3,0,8
1706,FBXO21 ,1,0,0,1,0,2
1717,OXSR1 ,0,1,0,4,0,5
1723,SERPINA1 ,0,1,1,0,0,2
1732,JAK2 ,0,2,3,0,0,5
1738,DDX4 ,2,1,0,0,0,3
1748,CCN6 ,0,0,1,2,0,3
1759,EBPL ,0,0,3,1,0,4
1767,MACF1 ,5,0,0,1,0,6
1776,POLR2F ,1,0,1,1,0,3
1782,HYAL3 ,0,1,1,0,0,2
1784,AFMID ,0,0,3,1,0,4
1796,RPL3 ,2,1,0,0,0,3
1801,CTH ,2,1,1,0,0,4
1802,SAFB2 ,5,0,0,1,0,6
1805,CAPNS1 ,1,0,0,1,0,2
1808,ENO3 ,6,1,0,0,0,7
1811,ATP2A3 ,0,1,3,0,0,4
1814,SIRT1 ,0,1,0,1,0,2
1824,DDIT3 ,0,1,1,0,0,2
1843,TFRC ,1,1,0,0,0,2
1847,TMED3 ,1,0,1,0,0,2
1852,RTCB ,0,1,1,0,0,2
1871,RBM39 ,5,0,0,1,0,6
1872,WIPF2 ,1,0,0,1,0,2
1882,CD302 ,0,1,0,3,0,4
1885,BTN2A2 ,0,0,1,1,0,2
1887,LY6G6D ,0,1,0,1,0,2
1896,CDADC1 ,5,0,2,0,0,7
1909,GHRL ,0,0,2,2,0,4
1912,SVIL ,6,0,1,0,0,7
1950,CCAR1 ,5,0,0,1,0,6
1953,TAF5L ,0,0,4,1,0,5
1961,PSMC3 ,4,0,2,1,0,7
1964,SLC10A3 ,3,1,1,0,0,5
1968,GAL ,1,0,2,0,0,3
1979,COLEC12 ,0,1,0,2,0,3
1988,BTNL9 ,0,0,1,1,0,2
1991,ARL6IP5 ,2,1,0,0,0,3
1998,RELL2 ,0,0,2,1,0,3
2019,DRAXIN ,0,0,1,1,0,2
2034,FADS1 ,0,1,1,0,0,2
2037,GPATCH8 ,0,0,3,2,0,5
2043,NPR2 ,0,0,1,1,0,2
2050,NIP7 ,0,1,0,2,0,3
2063,SLC35F5 ,0,1,0,2,0,3
2064,ZAN ,1,0,0,3,0,4
2065,DNAJC4 ,0,0,1,2,0,3
2071,UBE4B ,0,0,2,1,0,3
2072,NOS3 ,1,0,5,0,0,6
2089,ERCC3 ,0,0,3,1,0,4
2097,NPY1R ,0,1,1,0,0,2
2098,VPS53 ,9,0,1,0,0,10
2117,NR6A1 ,1,0,2,0,0,3
2124,BMPR1B ,0,1,1,0,0,2
2128,GCLM ,1,0,1,0,0,2
2134,TRIO ,2,0,1,0,0,3
2135,GFM2 ,6,0,1,0,0,7
2150,CACNB3 ,0,0,4,1,0,5
2159,NUP85 ,4,0,1,0,0,5
2169,TPRG1L ,0,0,3,1,0,4
2171,LOC100620540 ,0,0,3,4,0,7
2182,USP38 ,0,0,1,1,0,2
2190,PALMD ,0,1,2,0,0,3
2192,MBP ,4,0,2,0,0,6
2198,MYD88 ,0,1,0,2,0,3
2211,ATP6V0C ,1,0,1,0,0,2
2215,ADGB ,0,0,5,2,0,7
2216,ING3 ,0,0,2,2,0,4
2233,GNG5 ,0,0,4,1,0,5
2244,SDHD ,1,0,2,0,0,3
2283,HYAL1 ,0,1,2,1,0,4
2287,ABCF3 ,0,1,0,2,0,3
2293,POLI ,0,0,2,1,0,3
2298,DPT ,1,0,1,0,0,2
2309,RPL15 ,2,1,0,0,0,3
2314,ITIH1 ,3,1,0,0,0,4
2323,CASP3 ,1,0,3,0,0,4
2324,SCIN ,4,1,0,0,0,5
2348,GGT1 ,0,1,6,0,0,7
2349,RGS7 ,4,0,0,1,0,5
2356,METTL3 ,0,1,1,0,0,2
2361,MSN ,4,1,0,0,0,5
2389,SLC25A23 ,0,1,4,0,0,5
2390,LSM14B ,0,0,2,1,0,3
2391,SLC25A29 ,0,0,3,1,0,4
2402,PTN ,0,1,1,0,0,2
2404,METTL14 ,0,1,1,0,0,2
2406,CRTC3 ,0,1,2,0,0,3
2408,RAF1 ,0,0,2,1,0,3
2414,UPK2 ,0,1,0,1,0,2
2420,SEC61A2 ,4,0,2,0,0,6
2435,MDC1 ,0,0,1,4,0,5
2442,TMBIM1 ,4,0,1,0,0,5
2448,PDGFB ,1,0,1,0,0,2
2466,NPSR1 ,0,0,1,2,0,3
2469,TSC22D1 ,2,0,0,1,0,3
2489,POLK ,0,0,2,3,0,5
2491,GLB1L2 ,8,0,1,0,0,9
2514,SLC44A4 ,4,0,1,0,0,5
2515,MACO1 ,0,1,2,0,0,3
2523,ADCY3 ,1,0,1,0,0,2
2525,HNF1B ,1,0,5,0,0,6
2533,TRAF4 ,0,0,1,1,0,2
2535,USP48 ,0,0,3,1,0,4
2551,ACR ,1,0,1,0,0,2
2554,DPY19L1 ,5,0,1,0,0,6
2562,PLK4 ,4,0,0,3,0,7
2569,TNFSF4 ,0,1,1,0,0,2
2579,PSME2 ,0,1,4,1,0,6
2587,KCNK17 ,0,0,1,1,0,2
2588,HSPB11 ,1,0,0,2,0,3
2599,TRIM8 ,0,1,0,1,0,2
2600,NR3C1 ,0,1,2,0,0,3
2602,RPLP1 ,2,0,1,0,0,3
2603,AQP1 ,0,1,2,0,0,3
2610,RAB33A ,0,1,1,0,0,2
2615,SLA-DQB1 ,2,0,0,2,0,4
2616,COX7A2 ,3,0,0,1,0,4
2630,STMN1 ,1,1,0,0,0,2
2639,ST3GAL3 ,0,1,6,2,0,9
2641,CYP2D6 ,0,1,1,0,0,2
2645,CARD9 ,0,1,0,4,0,5
2657,ISG20 ,1,0,0,2,0,3
2665,RAP2C ,1,0,0,1,0,2
2666,SMARCE1 ,5,0,0,1,0,6
2673,SERPINE1 ,0,1,1,0,0,2
2676,NSMCE1 ,0,0,2,1,0,3
2689,RSPO1 ,0,0,2,1,0,3
2691,PRKAG3 ,0,1,0,3,0,4
2692,BGN ,1,1,0,0,0,2
2704,TOLLIP ,0,0,2,2,0,4
2710,TUBA1A ,1,0,2,0,0,3
2713,VASP ,0,0,2,1,0,3
2721,TGFB3 ,0,1,2,0,0,3
2737,S100A12 ,1,0,0,1,0,2
2742,LY6E ,0,1,0,2,0,3
2753,ST8SIA2 ,0,1,1,0,0,2
2757,UTS2 ,0,1,2,0,0,3
2758,HERPUD1 ,4,0,0,1,0,5
2761,FAR1 ,0,1,4,0,0,5
2766,SH3RF1 ,0,0,1,1,0,2
2770,MITF ,0,1,5,0,0,6
2776,FAXC ,2,0,1,1,0,4
2778,KDM4B ,0,0,2,2,0,4
2798,NDUFA3 ,1,0,1,0,0,2
2803,AMBP ,1,0,2,0,0,3
2807,FGF1 ,2,0,1,0,0,3
2808,NLRP3 ,0,1,4,0,0,5
2810,MED12 ,0,1,3,0,0,4
2812,SCML4 ,0,0,2,4,0,6
2813,COPS7A ,5,0,0,1,0,6
2816,P4HB ,0,1,3,0,0,4
2830,CYLD ,0,1,0,4,0,5
2836,RSPO4 ,0,0,1,1,0,2
2850,LOC110260307 ,1,0,0,5,0,6
2852,REPS2 ,2,0,0,2,0,4
2854,CNST ,4,0,0,1,0,5
2863,SAP30 ,1,0,1,0,0,2
2866,GAB2 ,0,1,0,2,0,3
2879,YPEL3 ,0,0,3,1,0,4
2880,ENTPD1 ,1,0,2,0,0,3
2885,YTHDF3 ,3,0,0,1,0,4
2887,NSA2 ,0,0,1,1,0,2
2890,GALNT1 ,1,1,0,1,0,3
2891,BCL11A ,0,1,0,5,0,6
2907,DHDDS ,0,0,4,1,0,5
2923,PMP22 ,0,0,3,1,0,4
2929,IGF1 ,0,2,7,0,0,9
2951,TNRC6A ,0,0,4,3,0,7
2957,SOD2 ,4,1,0,0,0,5
2973,SUCLG1 ,1,0,7,0,0,8
2976,FMN2 ,0,0,1,1,0,2
2978,ZER1 ,4,0,2,0,0,6
2985,BAALC ,0,1,0,1,0,2
2987,ODC1 ,0,1,3,0,0,4
3001,LITAF ,0,0,2,1,0,3
3002,C17H20ORF173 ,0,0,2,1,0,3
3004,CCN2 ,0,1,2,0,0,3
3006,ANGPTL7 ,0,1,0,1,0,2
3011,MCM6 ,0,1,1,0,0,2
3014,TNNT1 ,7,1,0,0,0,8
3021,MVB12B ,0,0,1,1,0,2
3034,CAPN7 ,0,1,1,0,0,2
3035,ATP6AP2 ,5,0,0,1,0,6
3039,DCLRE1C ,0,0,5,1,0,6
3046,GLP1R ,0,1,1,0,0,2
3048,ERO1A ,0,1,2,0,0,3
3063,CCL8 ,0,1,1,0,0,2
3068,C1QBP ,0,1,1,0,0,2
3071,DHRS3 ,0,1,1,0,0,2
3080,POU2F2 ,0,1,8,0,0,9
3093,GRINA ,0,0,1,1,0,2
3106,FOXN3 ,0,1,0,2,0,3
3123,DIO2 ,0,1,1,0,0,2
3135,PUS10 ,0,0,2,1,0,3
3141,ULK3 ,0,0,3,1,0,4
3149,SLC22A7 ,0,1,0,1,0,2
3161,LOC100621844 ,3,0,2,0,0,5
3164,PRKAB2 ,2,0,1,0,0,3
3192,MED14 ,0,1,2,0,0,3
3223,PIK3CA ,0,1,2,0,0,3
3227,ADAM9 ,3,0,0,1,0,4
3234,PIK3R6 ,0,0,1,2,0,3
3243,COASY ,1,0,3,0,0,4
3246,LRP5 ,0,0,4,1,0,5
3252,EXTL2 ,3,0,0,1,0,4
3257,MFNG ,0,0,1,3,0,4
3271,PPARD ,0,1,0,1,0,2
3278,CES1 ,8,0,5,4,0,17
3282,FAM193B ,0,0,1,2,0,3
3283,RAB6A ,5,0,0,1,0,6
3284,ATF2 ,0,0,4,2,0,6
3285,LBR ,0,1,1,0,0,2
3304,TRAPPC13 ,6,0,0,1,0,7
3306,MYDGF ,0,1,0,1,0,2
3315,ISG12(A) ,0,0,2,1,0,3
3355,ZDHHC16 ,0,0,3,1,0,4
3376,BCL10 ,0,1,0,2,0,3
3381,UPF3A ,0,0,4,3,0,7
3390,MLH1 ,0,0,2,1,0,3
3392,KLHL21 ,0,1,0,1,0,2
3405,CNIH4 ,4,0,2,0,0,6
3406,ATP5F1D ,2,1,0,0,0,3
3411,FIGLA ,0,1,0,1,0,2
3415,MOXD1 ,0,0,1,1,0,2
3421,NXPE3 ,0,0,1,1,0,2
3425,TSSK4 ,0,1,0,1,0,2
3430,GNPTAB ,0,0,4,1,0,5
3431,VPS35L ,4,0,1,0,0,5
3433,ID4 ,0,1,0,1,0,2
3449,ATP5PO ,1,0,2,0,0,3
3450,AGPS ,7,0,1,0,0,8
3454,SLA-DMA ,2,0,0,1,0,3
3459,PCMTD2 ,0,1,1,0,0,2
3481,LOC100521447 ,0,0,3,1,0,4
3488,P3H2 ,0,0,3,1,0,4
3499,CLEC4E ,0,1,0,1,0,2
3500,SZT2 ,3,0,0,1,0,4
3511,LMNA ,5,0,1,0,0,6
3519,MPPED1 ,0,0,1,1,0,2
3520,HMGCR ,0,1,3,0,0,4
3528,FABP1 ,0,1,2,0,0,3
3532,CIDEB ,0,1,0,1,0,2
3535,MEA1 ,0,1,0,2,0,3
3547,MUC2 ,2,0,0,2,0,4
3553,TRH ,1,1,0,0,0,2
3554,CYP2E1 ,2,1,0,0,0,3
3556,IL27 ,0,1,0,1,0,2
3564,SPI1 ,0,1,2,0,0,3
3573,KIF4A ,0,0,3,1,0,4
3575,ABCC2 ,3,0,0,1,0,4
3602,APOM ,1,1,0,0,0,2
3609,USP45 ,0,0,2,1,0,3
3622,PGD ,2,1,0,0,0,3
3623,CDH5 ,0,2,0,2,0,4
3638,RPL28 ,1,0,1,0,0,2
3642,WASHC3 ,2,0,1,0,0,3
3649,LDHC ,0,2,3,2,0,7
3652,CYP8B1 ,1,0,1,0,0,2
3676,BTG3 ,0,1,1,0,0,2
3683,EPC1 ,0,0,1,2,0,3
3684,UQCC1 ,0,1,5,1,0,7
3692,VDAC3 ,3,1,0,0,0,4
3694,OAS1 ,1,0,1,0,0,2
3701,G6PC1 ,0,1,0,1,0,2
3712,MRPL52 ,1,0,2,0,0,3
3714,LHCGR ,0,1,1,2,0,4
3716,CDH3 ,0,1,0,1,0,2
3717,PTGDS ,1,0,2,0,0,3
3723,GSG1L ,0,0,2,1,0,3
3730,HSD17B7 ,0,0,2,1,0,3
3753,GPX5 ,1,0,1,0,0,2
3756,FIS1 ,1,0,0,1,0,2
3761,RSC1A1 ,3,1,0,1,0,5
3769,PRKACB ,1,0,5,0,0,6
3772,LEPROT ,0,1,3,0,0,4
3778,PRKAR1A ,1,0,2,0,0,3
3801,TF ,1,0,7,0,0,8
3805,CASP8 ,0,1,2,0,0,3
3820,CHAT ,1,0,1,0,0,2
3837,MDM4 ,0,0,4,6,0,10
3842,ERLEC1 ,6,0,0,1,0,7
3846,EDN1 ,1,0,1,0,0,2
3847,AIFM1 ,5,0,0,1,0,6
3856,VIP ,1,1,0,0,0,2
3875,LGALS2 ,1,1,0,0,0,2
3881,LOC100624109 ,3,0,2,0,0,5
3888,PYY ,2,1,0,0,0,3
3889,RBPMS ,5,0,0,1,0,6
3892,ZUP1 ,0,0,2,1,0,3
3893,GJA4 ,0,1,1,0,0,2
3905,SLC22A2 ,0,1,1,0,0,2
3940,PLIN2 ,3,1,0,0,0,4
3946,LRP8 ,0,1,0,7,0,8
3971,ZPBP ,0,1,2,0,0,3
3978,TLR4 ,0,1,2,0,0,3
3983,TSPAN3 ,0,0,3,1,0,4
3998,PDIK1L ,0,0,1,1,0,2
4000,DCUN1D5 ,2,0,0,1,0,3
4002,TACC2 ,4,0,1,0,0,5
4004,CD55 ,0,1,0,6,0,7
4037,DPP9 ,0,1,0,3,0,4
4040,RPL29 ,2,0,1,0,0,3
4065,HPSE2 ,0,0,2,2,0,4
4066,AKAP7 ,3,0,0,1,0,4
4069,HFE ,0,0,5,3,0,8
4070,CD207 ,0,1,0,1,0,2
4074,TBC1D9 ,0,1,0,3,0,4
4087,RANBP6 ,1,0,0,1,0,2
4092,NFKBIL1 ,0,0,1,2,0,3
4099,IRF2 ,0,1,1,2,0,4
4103,DRD2 ,0,2,1,0,0,3
4105,RPL11 ,4,0,1,0,0,5
4117,TMEM62 ,2,0,0,1,0,3
4120,BRAF ,0,0,6,1,0,7
4133,PRL ,1,0,3,0,0,4
4137,ESRP1 ,0,0,4,1,0,5
4143,RANBP10 ,0,0,3,1,0,4
4151,PIGK ,0,1,4,0,0,5
4170,RBP7 ,0,1,0,2,0,3
4181,NR3C2 ,0,1,0,5,0,6
4185,ERN1 ,5,0,0,3,0,8
4191,FUT1 ,0,1,1,0,0,2
4203,NRG2 ,0,0,5,1,0,6
4230,ELF4 ,0,1,1,0,0,2
4242,WDR81 ,0,1,0,3,0,4
4243,PPY ,1,0,1,0,0,2
4251,HSP90B1 ,2,1,0,0,0,3
4252,TMEM175 ,0,0,4,1,0,5
4255,CHCHD7 ,1,0,0,1,0,2
4258,HK2 ,0,1,2,0,0,3
4259,POU5F1 ,1,0,1,0,0,2
4261,TSHR ,1,0,5,1,0,7
4262,OVGP1 ,0,1,0,3,0,4
4286,RPL10A ,3,1,0,0,0,4
4292,MT-ND1 ,1,0,1,0,0,2
4294,NUDT4 ,1,0,0,1,0,2
4299,CABP1 ,4,0,0,4,0,8
4302,GHRHR ,0,1,0,1,0,2
4305,METTL15 ,0,0,2,1,0,3
4307,ST14 ,0,0,1,1,0,2
4311,SLC25A44 ,0,1,1,0,0,2
4315,RAMP2 ,0,1,1,0,0,2
4319,S100A10 ,1,1,0,0,0,2
4326,MAST4 ,0,0,7,2,0,9
4328,MTX1 ,0,1,1,1,0,3
4332,HEXB ,5,0,1,0,0,6
4338,POMGNT1 ,0,0,4,1,0,5
4354,SCG2 ,0,1,1,0,0,2
4365,PDLIM3 ,3,1,0,0,0,4
4379,SLA-6 ,5,0,3,0,0,8
4380,FFAR2 ,0,1,1,0,0,2
4386,CRYBG1 ,4,0,1,0,0,5
4387,PREP ,1,0,3,0,0,4
4407,GDI2 ,4,1,1,0,0,6
4435,BRIX1 ,0,0,3,3,0,6
4445,TNFRSF1A ,0,1,0,2,0,3
4450,WDR44 ,0,1,0,2,0,3
4451,WDR1 ,0,1,0,2,0,3
4452,MEF2A ,0,1,0,4,0,5
4457,HBEGF ,0,1,0,1,0,2
4468,ADCYAP1R1 ,0,1,0,3,0,4
4485,JOSD2 ,2,0,0,3,0,5
4514,VCAN ,3,0,0,3,0,6
4516,SLC35C1 ,0,1,2,0,0,3
4517,SAT2 ,1,1,0,0,0,2
4526,TBC1D9B ,4,0,0,5,0,9
4528,INPP5F ,7,0,0,1,0,8
4534,NFE2L2 ,0,1,0,6,0,7
4535,IQSEC2 ,0,0,3,1,0,4
4537,ORC5 ,0,0,6,1,0,7
4547,DCAF11 ,0,0,2,1,0,3
4549,SERPINA6 ,0,1,2,0,0,3
4551,PARD3 ,0,0,6,2,0,8
4553,POU1F1 ,0,1,1,1,0,3
4565,ZFP91 ,3,0,1,0,0,4
4566,TGFBR1 ,0,1,4,0,0,5
4572,MTRF1L ,1,0,1,0,0,2
4583,GAD2 ,0,1,2,0,0,3
4590,RAB31 ,5,0,0,1,0,6
4591,SOX9 ,0,1,0,1,0,2
4597,NUP35 ,0,0,1,1,0,2
4598,KCTD21 ,0,1,0,1,0,2
4600,TGFB2 ,1,0,3,0,0,4
4612,MRPL23 ,1,0,2,0,0,3
4624,NECTIN1 ,1,0,0,2,0,3
4630,EIF4E2 ,5,0,1,0,0,6
4644,DAD1 ,2,0,1,0,0,3
4646,ELF2 ,0,0,5,1,0,6
4648,CYBRD1 ,2,0,0,1,0,3
4649,TTC39C ,0,0,2,1,0,3
4667,PECAM1 ,0,1,0,7,0,8
4668,SELE ,0,1,1,0,0,2
4674,STX17 ,0,0,2,1,0,3
4679,FUZ ,0,0,2,1,0,3
4682,RPL7A ,0,1,3,0,0,4
4684,CDC42 ,1,1,0,1,0,3
4688,LRRC8C ,0,0,4,1,0,5
4694,CXCL12 ,0,1,2,0,0,3
4696,SMAD4 ,2,1,1,0,0,4
4698,ADCY7 ,0,0,2,2,0,4
4712,TAC4 ,0,1,3,0,0,4
4713,ZAP70 ,0,0,1,2,0,3
4728,SAL1 ,1,0,1,0,0,2
4730,MVD ,0,0,1,1,0,2
4744,APP ,0,2,5,0,0,7
4760,SFXN1 ,3,1,0,0,0,4
4765,HSCB ,0,0,1,1,0,2
4769,SLC6A13 ,2,0,1,0,0,3
4776,IWS1 ,0,1,0,3,0,4
4779,SKIV2L ,2,0,0,1,0,3
4787,MRPS18C ,0,0,1,2,0,3
4796,UGT8 ,0,1,1,0,0,2
4798,CD46 ,1,0,0,6,0,7
4801,IFI30 ,0,1,2,0,0,3
4806,HEMGN ,2,0,0,2,0,4
4811,SSX2IP ,0,0,4,1,0,5
4813,RFTN1 ,3,0,1,0,0,4
4830,EML6 ,0,0,1,1,0,2
4835,ZNF483 ,0,0,2,1,0,3
4838,EIF3B ,0,1,1,0,0,2
4839,FABP6 ,2,0,2,0,0,4
4853,KMT2E ,0,1,0,2,0,3
4857,CLCN7 ,0,0,6,1,0,7
4876,EML3 ,2,0,1,0,0,3
4895,PRKCQ ,0,0,7,1,0,8
4897,KAT7 ,0,1,5,0,0,6
4901,CSNK1D ,0,0,3,1,0,4
4906,SNRPG ,1,0,1,0,0,2
4912,PPIA ,1,0,3,0,0,4
4915,PTPN14 ,0,0,1,1,0,2
4916,MRPS6 ,1,0,1,0,0,2
4920,UTP6 ,0,0,3,2,0,5
4924,PEX13 ,0,0,2,2,0,4
4927,ADA2 ,0,1,1,0,0,2
4937,CDK18 ,0,0,2,1,0,3
4953,LOC110259262 ,5,0,0,1,0,6
4954,FLT4 ,1,0,0,1,0,2
4956,SCT ,1,0,2,0,0,3
4966,AKR1B1 ,1,0,2,0,0,3
4975,CD40LG ,0,1,2,0,0,3
4988,EDNRA ,0,1,1,2,0,4
5016,SOD1 ,1,0,1,0,0,2
5018,TSPAN6 ,0,0,1,2,0,3
5029,UCP2 ,0,1,2,0,0,3
5042,MKNK1 ,0,1,2,0,0,3
5063,EXOG ,2,0,0,1,0,3
5065,OPRD1 ,1,0,1,0,0,2
5084,PRPS2 ,4,0,1,0,0,5
5092,RAD18 ,0,1,4,3,0,8
5095,PRM2 ,0,1,1,0,0,2
5101,PCDH11X ,0,1,0,7,0,8
5112,PIGP ,0,0,1,3,0,4
5115,IL6R ,0,1,4,0,0,5
5124,CNN1 ,0,1,3,0,0,4
5139,SFTPD ,1,0,2,0,0,3
5145,PEMT ,2,0,2,0,0,4
5152,KCNMA1 ,0,1,7,0,0,8
5160,CD70 ,0,1,1,0,0,2
5173,ALDH2 ,3,1,0,0,0,4
5183,PAN2 ,0,0,4,1,0,5
5185,RPLP0 ,1,0,4,0,0,5
5194,PTGER2 ,0,0,1,1,0,2
5200,EXOSC3 ,0,0,1,1,0,2
5207,XRCC3 ,0,0,1,1,0,2
5223,SH3GL3 ,0,0,3,2,0,5
5231,TMEM19 ,3,0,4,0,0,7
5246,KLF11 ,0,1,0,2,0,3
5258,KAT6B ,0,0,4,2,0,6
5272,ADCY2 ,1,0,1,0,0,2
5278,LOC100621521 ,3,0,1,0,0,4
5283,HDAC8 ,0,0,7,2,0,9
5285,CRYAB ,2,1,0,0,0,3
5295,PTGER3 ,0,1,0,4,0,5
5298,ACTG2 ,7,0,1,0,0,8
5338,ACTG1 ,3,0,1,0,0,4
5355,TRAF6 ,0,1,2,0,0,3
5358,FRMD5 ,2,0,0,2,0,4
5368,SLPI ,1,0,0,2,0,3
5372,TMSB10 ,1,0,1,0,0,2
5381,UBC ,0,1,0,2,0,3
5382,CTRC ,2,0,0,1,0,3
5386,HPCA ,0,1,0,4,0,5
5398,EIF4EBP2 ,1,0,1,0,0,2
5400,RPLP2 ,2,0,1,0,0,3
5409,SLC39A6 ,0,1,0,1,0,2
5414,CIT ,0,0,4,1,0,5
5436,DDX39B ,4,0,1,0,0,5
5440,IL6ST ,0,0,2,2,0,4
5442,NME2 ,2,1,0,0,0,3
5445,AJAP1 ,0,1,0,1,0,2
5448,RNF220 ,2,0,0,1,0,3
5450,AKAP3 ,0,1,3,0,0,4
5463,CALCR ,0,1,2,1,0,4
5464,SPRP ,0,1,1,0,0,2
5475,D2HGDH ,5,0,1,0,0,6
5486,IFRD1 ,0,1,3,1,0,5
5493,LAMA3 ,1,0,0,1,0,2
5496,STAR ,2,2,0,0,0,4
5503,TRIT1 ,0,0,5,3,0,8
5509,CENPT ,0,0,2,1,0,3
5511,PKP4 ,8,0,0,1,0,9
5525,TSC1 ,3,0,0,1,0,4
5530,RFNG ,0,0,1,1,0,2
5536,NELL2 ,3,0,0,1,0,4
5541,SLC4A4 ,1,0,9,0,0,10
5545,COL4A2 ,3,0,0,2,0,5
5547,CCZ1 ,1,0,1,0,0,2
5559,IGFBP6 ,2,0,0,1,0,3
5598,SCAP ,0,1,5,0,0,6
5600,PRSS55 ,7,0,0,2,0,9
5619,CNP ,2,0,0,1,0,3
5621,FYN ,2,1,0,0,0,3
5623,RET ,0,0,1,1,0,2
5624,IGF2 ,1,0,6,0,0,7
5626,CTSL ,0,1,1,0,0,2
5628,LRP2 ,1,0,1,0,0,2
5629,GALK2 ,7,0,1,0,0,8
5649,SFXN5 ,4,0,1,0,0,5
5662,ANGPT1 ,0,1,0,3,0,4
5665,MYLK ,7,1,0,0,0,8
5673,LIMK2 ,0,0,6,2,0,8
5674,CLU ,1,0,2,0,0,3
5693,ATPAF2 ,0,0,1,1,0,2
5698,SPTBN1 ,4,0,1,0,0,5
5706,IL1RL1 ,0,0,2,1,0,3
5716,ATG5 ,0,1,8,1,0,10
5719,ACVR1 ,0,1,2,0,0,3
5723,RBBP6 ,0,1,0,4,0,5
5725,DOK4 ,0,0,1,3,0,4
5734,ZBTB22 ,4,0,0,1,0,5
5757,COX17 ,1,1,0,0,0,2
5763,OBSCN ,0,0,1,1,0,2
5770,GNE ,0,1,0,3,0,4
5777,PRRT2 ,1,0,1,0,0,2
5778,STOM ,2,0,0,1,0,3
5788,GMPPA ,1,0,1,0,0,2
5811,PDZK1IP1 ,0,0,1,3,0,4
5819,CLMN ,1,0,0,1,0,2
5823,STAT3 ,1,0,3,0,0,4
5825,SPAG6 ,0,1,0,4,0,5
5842,CYP2C42 ,10,1,0,0,0,11
5844,CNPY3 ,2,0,1,0,0,3
5850,PLXNA4 ,0,0,1,2,0,3
5855,DDX58 ,0,1,2,1,0,4
5873,BLOC1S6 ,0,0,1,2,0,3
5874,SYT5 ,1,0,0,1,0,2
5879,BDNF ,1,0,1,0,0,2
5894,MRPL9 ,1,0,2,0,0,3
5895,CEP57L1 ,0,0,3,1,0,4
5912,IL18 ,0,1,3,0,0,4
5923,TOM1L2 ,0,0,6,1,0,7
5934,CAV1 ,0,1,2,0,0,3
5948,CHRM2 ,1,0,1,0,0,2
5949,CALCRL ,1,0,3,0,0,4
5950,APEH ,1,0,0,3,0,4
5977,WNK1 ,0,1,0,1,0,2
6009,FLCN ,0,0,1,1,0,2
6013,PHIP ,0,1,0,1,0,2
6016,SLC25A32 ,1,0,1,0,0,2
6017,WDR45 ,1,1,3,0,0,5
6021,OGT ,0,1,5,1,0,7
6030,BVES ,0,1,2,0,0,3
6031,CHEK1 ,0,0,3,1,0,4
6037,NBEAL2 ,0,0,4,1,0,5
6045,CYB561 ,0,1,0,4,0,5
6046,TGFBR3 ,0,1,0,6,0,7
6053,PLA2G1B ,1,0,3,0,0,4
6063,RPRD1A ,4,0,0,1,0,5
6064,TERB1 ,4,0,0,1,0,5
6070,SLC39A14 ,4,0,0,3,0,7
6072,IL15 ,0,1,3,0,0,4
6078,UBR4 ,1,0,0,1,0,2
6102,SPINK1 ,1,0,0,1,0,2
6110,PTH1R ,1,0,3,0,0,4
6116,ROCK2 ,1,0,5,0,0,6
6120,CAPN2 ,3,1,0,0,0,4
6129,THNSL2 ,2,0,0,2,0,4
6143,PKMYT1 ,0,0,1,1,0,2
6152,MRPS14 ,1,0,2,0,0,3
6158,PDE8B ,0,0,5,1,0,6
6165,NDRG3 ,9,0,0,1,0,10
6174,TXNDC12 ,2,0,0,1,0,3
6176,HPGD ,3,0,0,2,0,5
6179,TCN1 ,1,0,1,0,0,2
6180,ITGA4 ,0,0,1,1,0,2
6184,PSMB4 ,1,1,0,0,0,2
6191,AHSA1 ,1,0,1,0,0,2
6196,CCR5 ,0,1,1,0,0,2
6208,SCD ,0,1,3,0,0,4
6211,CAPZB ,6,1,0,0,0,7
6212,GTF2A2 ,0,0,2,1,0,3
6218,LGR5 ,0,1,0,3,0,4
6234,LGSN ,0,0,1,1,0,2
6237,SMAD1 ,0,1,1,0,0,2
6241,RELA ,0,1,0,2,0,3
6244,SHROOM2 ,2,0,0,1,0,3
6249,FLAD1 ,7,0,1,0,0,8
6266,PCNP ,1,0,0,1,0,2
6268,CCND3 ,0,0,3,2,0,5
6273,NDP ,0,1,0,1,0,2
6279,AIDA ,3,0,1,0,0,4
6282,KRT33A ,1,0,1,1,0,3
6284,SH2D1A ,0,1,0,2,0,3
6305,HPX ,1,0,2,2,0,5
6309,CASQ2 ,2,1,0,0,0,3
6310,L3MBTL1 ,3,0,0,1,0,4
6331,PPP1R1B ,4,1,0,0,0,5
6333,SMAD3 ,0,1,1,0,0,2
6340,PNOC ,1,0,2,0,0,3
6358,TMPRSS15 ,1,0,4,0,0,5
6360,MYOCD ,0,1,0,4,0,5
6369,SCNN1B ,0,0,1,1,0,2
6391,MOSPD3 ,0,1,0,4,0,5
6393,NEMF ,0,0,2,1,0,3
6394,ATF7IP2 ,0,0,1,2,0,3
6411,ANXA4 ,1,0,3,0,0,4
6414,TSPAN17 ,0,0,2,1,0,3
6417,WDFY2 ,5,0,0,2,0,7
6418,CFAP69 ,0,0,5,3,0,8
6421,ITPR1 ,5,0,0,2,0,7
6428,AP4E1 ,0,0,3,2,0,5
6447,NMB ,1,0,2,0,0,3
6472,VTN ,3,0,0,1,0,4
6496,STAT1 ,9,1,0,0,0,10
6505,SNRPF ,1,0,1,0,0,2
6519,BPIFA1 ,0,1,2,0,0,3
6523,ATG4B ,0,1,4,0,0,5
6539,GOLT1B ,3,0,0,1,0,4
6540,HOXA13 ,0,0,1,1,0,2
6561,MED27 ,0,1,4,0,0,5
6570,DNAH10 ,0,0,2,1,0,3
6578,DPM1 ,1,0,1,0,0,2
6579,MRPS5 ,1,0,5,0,0,6
6590,PCCB ,1,0,0,6,0,7
6599,C1QA ,0,1,0,1,0,2
6621,SMPX ,0,1,1,0,0,2
6627,BOLA3 ,1,0,1,1,0,3
6630,NCOA2 ,0,1,2,2,0,5
6636,TIMP1 ,0,1,1,1,0,3
6640,APOE ,1,0,1,0,0,2
6662,FAM120C ,3,0,1,0,0,4
6667,NAA10 ,3,0,0,1,0,4
6673,MRTFB ,0,0,1,2,0,3
6675,CAPN1 ,3,1,0,0,0,4
6682,MLN ,1,0,2,0,0,3
6687,IRF8 ,0,1,0,1,0,2
6689,PHF21A ,4,0,0,2,0,6
6702,DHX57 ,0,1,0,2,0,3
6711,ATP5MC3 ,0,1,2,0,0,3
6712,CSTA ,2,0,2,0,0,4
6721,ZNF512B ,0,0,6,2,0,8
6726,SLC2A2 ,0,1,3,0,0,4
6739,LSR ,0,0,1,1,0,2
6767,CD80 ,0,2,0,1,0,3
6782,RGS16 ,1,0,0,2,0,3
6784,ME1 ,3,1,0,0,0,4
6787,FMOD ,1,1,0,0,0,2
6797,PGM3 ,1,0,3,0,0,4
6801,CFLAR ,0,0,3,2,0,5
6809,KCNB1 ,0,1,1,0,0,2
6824,PFKM ,8,1,0,0,0,9
6829,ARG1 ,1,1,0,0,0,2
6830,DOLPP1 ,2,0,1,0,0,3
6832,AP3S2 ,1,0,1,0,0,2
6835,ARHGAP31 ,0,1,0,2,0,3
6836,NUBPL ,1,0,2,0,0,3
6843,CAPN3 ,0,1,10,0,0,11
6849,PLA2G6 ,3,0,0,1,0,4
6856,PHF10 ,0,0,3,1,0,4
6862,HORMAD1 ,0,1,0,4,0,5
6863,CSF3 ,0,1,3,0,0,4
6864,GRB7 ,0,0,2,1,0,3
6865,MTMR14 ,0,0,2,7,0,9
6867,CHRNB1 ,0,0,5,1,0,6
6870,PBX3 ,0,0,5,1,0,6
6881,AGFG2 ,3,0,0,1,0,4
6892,MYF6 ,0,0,1,1,0,2
6900,TG ,1,0,3,0,0,4
6902,VPS13B ,0,0,4,1,0,5
6912,HSP90AA1 ,0,1,2,0,0,3
6921,LIMA1 ,3,1,0,0,0,4
6933,KIFBP ,1,0,1,0,0,2
6939,SPSB2 ,0,0,1,1,0,2
6951,RPIA ,0,1,1,0,0,2
6953,ELSPBP1 ,1,0,0,2,0,3
6958,SNX20 ,0,1,3,0,0,4
6964,CKB ,0,1,2,0,0,3
6965,SDS ,0,1,0,1,0,2
6972,JUP ,0,1,1,0,0,2
6981,BCL2L1 ,0,2,2,0,0,4
6986,TDO2 ,0,0,4,2,0,6
6988,SPMI ,0,1,2,0,0,3
6991,HSPA5 ,1,1,0,0,0,2
6995,GLI3 ,0,1,1,1,0,3
7000,GUSB ,1,0,1,0,0,2
7009,ACYP1 ,1,0,1,0,0,2
7014,CPSF6 ,3,0,0,1,0,4
7023,CD74 ,0,1,0,5,0,6
7035,BLOC1S5 ,0,1,2,0,0,3
7037,GRN ,4,0,2,0,0,6
7045,NGRN ,0,0,1,1,0,2
7050,KDM5C ,0,1,2,0,0,3
7062,BAMBI ,0,1,0,1,0,2
7069,COX4I1 ,4,1,0,0,0,5
7070,STAT4 ,0,1,2,0,0,3
7074,MARK4 ,0,0,1,3,0,4
7077,CMAH ,0,1,3,0,0,4
7078,LOC100524679 ,0,0,2,1,0,3
7088,CDK20 ,0,0,3,1,0,4
7105,HTR2A ,0,1,1,0,0,2
7109,GRP ,1,1,0,0,0,2
7114,SPAG8 ,1,0,0,2,0,3
7116,XRCC5 ,5,0,0,1,0,6
7117,C4H1ORF43 ,0,1,0,3,0,4
7120,AVPR2 ,0,1,2,0,0,3
7133,HPRT1 ,1,1,0,0,0,2
7139,AOPEP ,0,0,6,4,0,10
7153,COLGALT1 ,3,0,3,1,0,7
7163,ADAM17 ,5,1,0,0,0,6
7173,TPM4 ,6,1,0,0,0,7
7179,SELENOW ,0,0,1,1,0,2
7197,PIGT ,7,0,0,1,0,8
7198,POLB ,0,0,1,1,0,2
7203,SLC5A11 ,0,1,5,0,0,6
7209,MIS18BP1 ,0,1,0,2,0,3
7211,CHORDC1 ,0,1,0,3,0,4
7212,USP3 ,0,0,2,3,0,5
7219,GNA15 ,0,1,0,1,0,2
7224,KCNJ2 ,0,1,1,0,0,2
7233,CYP20A1 ,3,0,2,2,0,7
7266,SPATA22 ,0,1,1,3,0,5
7276,DNASE1 ,1,0,3,0,0,4
7291,ANKH ,1,0,1,0,0,2
7294,TRIM38 ,0,1,0,2,0,3
7297,TFR2 ,6,0,0,1,0,7
7301,NEDD9 ,0,0,3,1,0,4
7311,RPN2 ,3,1,0,0,0,4
7339,GPATCH1 ,0,0,1,1,0,2
7363,MYOG ,0,0,1,1,0,2
7366,RALYL ,0,0,2,4,0,6
7368,IPO13 ,4,0,0,1,0,5
7372,ATP4A ,1,0,3,0,0,4
7374,SLC2A4 ,0,1,5,0,0,6
7377,PLAA ,5,0,0,1,0,6
7383,ITIH2 ,0,1,3,0,0,4
7391,ARHGEF2 ,0,1,0,8,0,9
7405,SLC39A7 ,3,1,0,0,0,4
7407,ZFYVE28 ,0,0,1,2,0,3
7412,GPAM ,0,1,2,0,0,3
7415,PNLIP ,1,0,2,0,0,3
7416,TCF19 ,0,0,1,1,0,2
7417,MGAT4A ,0,0,3,2,0,5
7457,IGF1R ,0,2,1,0,0,3
7473,CDK16 ,0,0,2,3,0,5
7477,STING1 ,1,0,2,1,0,4
7480,HAUS4 ,2,0,0,2,0,4
7482,PGLYRP4 ,0,0,4,1,0,5
7491,POU3F3 ,0,1,1,0,0,2
7492,PWP2 ,0,0,2,1,0,3
7496,TREM2 ,0,1,0,2,0,3
7502,ENAM ,1,0,0,2,0,3
7510,TFCP2 ,0,0,2,1,0,3
7518,FOXO1 ,0,1,0,1,0,2
7521,SREBF2 ,0,1,0,3,0,4
7525,RDX ,9,1,0,0,0,10
7565,DMC1 ,0,1,2,0,0,3
7567,VWF ,3,1,2,0,0,6
7568,MAPK9 ,0,0,6,1,0,7
7569,ETS1 ,0,0,5,1,0,6
7573,ATP5MC1 ,1,1,2,0,0,4
7584,CDC14B ,0,0,6,1,0,7
7589,SPINK4 ,1,0,0,1,0,2
7595,CLCN2 ,0,0,4,1,0,5
7600,TMCO1 ,2,1,0,0,0,3
7615,PIK3C3 ,0,1,7,0,0,8
7626,FASLG ,0,1,1,0,0,2
7627,CCR10 ,0,1,2,0,0,3
7632,LOC100523244 ,0,0,2,1,0,3
7653,SLC7A7 ,0,1,0,2,0,3
7654,DTNB ,0,0,5,1,0,6
7657,LOC100516390 ,3,0,0,4,0,7
7662,KLF10 ,0,1,0,2,0,3
7666,DESI2 ,0,1,3,0,0,4
7685,CUBN ,1,0,0,2,0,3
7690,TUFT1 ,0,1,0,4,0,5
7695,NEK3 ,0,0,1,1,0,2
7699,CYP3A22 ,6,0,2,0,0,8
7710,PPM1K ,0,0,1,3,0,4
7714,PABPC1L ,0,0,1,1,0,2
7719,SAR1B ,1,1,0,0,0,2
7727,TSC22D4 ,0,0,2,3,0,5
7729,CRTC2 ,0,0,2,1,0,3
7735,DOCK2 ,0,1,3,0,0,4
7736,HM13 ,0,0,2,1,0,3
7739,GNA14 ,0,1,1,0,0,2
7747,ARFRP1 ,2,0,0,1,0,3
7757,SPATA6 ,0,1,6,0,0,7
7760,CASP10 ,0,0,3,1,0,4
7764,GANC ,0,0,1,1,0,2
7766,SNRPD2 ,2,1,0,0,0,3
7767,FGF9 ,0,1,1,0,0,2
7772,CYHR1 ,0,0,3,1,0,4
7778,FITM2 ,0,1,0,2,0,3
7799,DNASE1L1 ,0,1,2,0,0,3
7806,ENPEP ,1,0,4,0,0,5
7820,CYB5RL ,0,0,1,1,0,2
7826,EIF4EBP3 ,0,0,1,6,0,7
7828,GGCT ,2,0,0,1,0,3
7838,CYP19A1 ,0,1,9,0,0,10
7839,ELOVL2 ,4,0,1,0,0,5
7848,ITGAM ,9,0,1,0,0,10
7862,NR2F1 ,0,0,2,1,0,3
7868,HP ,1,0,1,1,0,3
7875,SLC17A1 ,0,1,0,2,0,3
7881,IMMP1L ,0,0,2,1,0,3
7888,MRPL35 ,1,0,3,0,0,4
7922,AMY2 ,1,0,1,0,0,2
7924,RSPO3 ,0,1,1,0,0,2
7931,CD3E ,0,1,0,4,0,5
7942,SLC22A13 ,1,0,2,0,0,3
7969,KATNAL2 ,0,0,1,2,0,3
7974,HSD17B8 ,3,0,1,0,0,4
7996,NPL ,1,0,4,1,0,6
8013,HPS4 ,0,1,0,4,0,5
8016,SMARCA2 ,3,0,0,4,0,7
8028,GSN ,1,0,4,0,0,5
8029,SLC12A6 ,0,1,5,0,0,6
8034,KCNN4 ,0,1,0,1,0,2
8039,CDK13 ,0,0,1,1,0,2
8041,AP4S1 ,1,0,2,0,0,3
8047,RBX1 ,0,0,1,1,0,2
8059,DDX24 ,0,0,1,1,0,2
8060,AMZ1 ,0,0,1,1,0,2
8064,PTCD2 ,0,0,2,2,0,4
8075,RNASEH2B ,0,0,4,1,0,5
8079,EHBP1 ,5,0,0,1,0,6
8083,PGC ,1,0,2,0,0,3
8084,SLC2A3 ,0,1,1,0,0,2
8087,AAAS ,5,0,0,1,0,6
8092,CDC42BPA ,7,0,2,0,0,9
8101,KCNIP1 ,0,1,0,4,0,5
8103,SLC25A6 ,0,1,5,0,0,6
8121,ARPIN ,2,0,1,0,0,3
8143,HMGB2 ,1,0,1,0,0,2
8147,PDZD11 ,2,1,0,0,0,3
8168,PSEN1 ,1,0,1,1,0,3
8169,BTBD11 ,3,0,0,1,0,4
8175,CMTR1 ,0,0,4,2,0,6
8176,WDR17 ,5,0,0,1,0,6
8183,NLRP12L ,0,1,0,4,0,5
8187,SRPK3 ,0,1,1,3,0,5
8188,AK6 ,0,0,2,2,0,4
8189,CBFB ,0,1,0,3,0,4
8206,APOBEC3B ,0,1,0,5,0,6
8212,FBXO31 ,0,0,3,1,0,4
8222,SLC6A19 ,1,0,0,1,0,2
8229,SCAMP1 ,0,1,2,0,0,3
8249,SPATA18 ,0,1,4,0,0,5
8257,RAB1A ,6,1,0,2,0,9
8258,GHR ,1,1,4,0,0,6
8266,STXBP5 ,8,0,0,1,0,9
8276,ENPP6 ,0,1,2,0,0,3
8277,EEFSEC ,5,0,0,1,0,6
8289,S1PR5 ,0,0,1,3,0,4
8290,MSMB ,1,0,1,0,0,2
8297,GSTA1 ,6,0,2,1,0,9
8307,DDX31 ,0,0,1,1,0,2
8308,RABAC1 ,0,1,3,0,0,4
8309,C7H15ORF40 ,1,0,1,0,0,2
8319,TBCA ,2,0,0,1,0,3
8327,GALNT3 ,0,0,2,1,0,3
8331,MRPL55 ,1,0,0,1,0,2
8333,RAD52 ,0,1,2,0,0,3
8337,MRPL2 ,1,0,0,2,0,3
8339,CTLA4 ,0,1,0,2,0,3
8340,MTX2 ,0,1,2,0,0,3
8345,MX2 ,2,1,0,0,0,3
8350,GH1 ,1,0,3,0,0,4
8351,CHRNG ,0,0,1,1,0,2
8355,NTF3 ,0,1,3,0,0,4
8373,POP4 ,0,0,2,1,0,3
8374,PGB ,1,0,1,0,0,2
8375,MRPL37 ,1,0,0,1,0,2
8379,CXADR ,3,0,0,1,0,4
8383,UBE2C ,0,0,1,2,0,3
8385,RPS6KB2 ,0,0,1,2,0,3
8394,NOTCH2 ,0,1,2,1,0,4
8395,RARA ,0,0,2,1,0,3
8401,GYPA ,1,0,0,1,0,2
8404,MYOZ1 ,0,1,1,0,0,2
8411,NME4 ,0,0,1,1,0,2
8415,FH ,1,0,3,0,0,4
8419,UCHL5 ,0,1,3,1,0,5
8431,SQLE ,0,1,1,0,0,2
8442,CYBA ,0,1,1,0,0,2
8443,XIRP2 ,0,0,3,1,0,4
8451,FST ,1,0,0,2,0,3
8456,RBM22 ,3,0,1,0,0,4
8488,TMC3 ,0,0,1,1,0,2
8501,ATM ,0,0,3,2,0,5
8515,CAPZA2 ,5,1,0,0,0,6
8517,FADS2 ,2,0,1,1,0,4
8548,CELA1 ,1,0,0,1,0,2
8550,CSAD ,4,0,1,0,0,5
8559,HTR2C ,0,1,2,1,0,4
8569,GLRB ,0,1,1,0,0,2
8571,HSPA6 ,1,0,1,0,0,2
8575,MLKL ,0,1,0,1,0,2
8581,OLR1 ,0,1,0,3,0,4
8584,TMEM91 ,7,0,2,0,0,9
8602,SCGN ,1,1,0,0,0,2
8603,AQP6 ,0,1,1,0,0,2
8617,CLDN2 ,0,1,1,0,0,2
8620,PTGR1 ,1,0,2,0,0,3
8628,CLCN1 ,0,0,5,2,0,7
8630,TMEM63B ,2,0,1,0,0,3
8637,NR1H4 ,0,1,4,1,0,6
8651,ACY1 ,1,0,9,0,0,10
8653,HMGN1 ,3,0,1,0,0,4
8658,ERGIC1 ,3,0,0,2,0,5
8664,TNRC6B ,0,0,7,2,0,9
8673,SDF2L1 ,2,0,0,1,0,3
8679,CLEC7A ,0,2,0,3,0,5
8683,ING5 ,0,0,1,1,0,2
8692,SLTM ,8,0,0,1,0,9
8700,MR1 ,0,2,2,0,0,4
8715,ADRB3 ,0,1,1,0,0,2
8722,SERPINA7 ,0,1,1,0,0,2
8738,N6AMT1 ,0,0,1,1,0,2
8742,QRICH1 ,3,0,0,1,0,4
8754,RPS3A ,2,0,1,0,0,3
8777,IL24 ,0,0,1,1,0,2
8786,LRRC7 ,0,0,3,3,0,6
8792,SLCO1A2 ,0,1,2,0,0,3
8808,NOC3L ,0,1,2,0,0,3
8809,KLF4 ,0,1,0,2,0,3
8813,CRTC1 ,0,0,2,1,0,3
8828,NTRK3 ,0,1,5,2,0,8
8835,VPS45 ,5,0,1,0,0,6
8836,CHD8 ,0,1,2,0,0,3
8843,CNN2 ,0,1,4,0,0,5
8853,CCHCR1 ,0,0,1,1,0,2
8856,MYOD1 ,0,0,1,1,0,2
8870,PPARG ,0,1,3,0,0,4
8886,GNAS ,5,1,0,2,0,8
8888,CHCHD1 ,1,0,0,1,0,2
8889,DCN ,0,1,8,0,0,9
8906,CD3D ,0,1,0,2,0,3
8910,SLC1A3 ,5,0,1,0,0,6
8912,MRPS2 ,1,0,2,0,0,3
8925,ATP5F1C ,1,0,1,0,0,2
8928,MAP2K5 ,0,0,8,2,0,10
8938,LMO4 ,0,1,0,2,0,3
8943,IKZF1 ,0,1,0,9,0,10
8945,DHDH ,4,0,2,2,0,8
8956,MAPK12 ,0,0,2,1,0,3
8962,TSNARE1 ,0,0,1,7,0,8
8965,TRIM46 ,3,0,0,1,0,4
9009,SMC2 ,0,0,3,1,0,4
9029,MRPS27 ,5,0,0,3,0,8
9035,RPL5 ,4,1,0,0,0,5
9041,LPL ,0,1,5,0,0,6
9086,ACADM ,1,0,5,0,0,6
9092,WDR83OS ,0,1,3,0,0,4
9095,POMC ,1,0,4,0,0,5
9108,KAT5 ,0,0,4,1,0,5
9135,TIMM17B ,0,0,1,1,0,2
9137,G6PC2 ,0,0,1,1,0,2
9138,SLC30A7 ,0,1,2,0,0,3
9144,RICTOR ,6,0,1,0,0,7
9162,ZP3 ,1,0,1,0,0,2
9166,RSAD2 ,1,1,0,3,0,5
9185,FCER1G ,0,0,3,1,0,4
9191,IKBKG ,1,0,0,4,0,5
9206,TAF5 ,0,0,1,1,0,2
9219,CELF6 ,0,0,4,1,0,5
9220,SATB2 ,0,0,3,1,0,4
9221,LGALS4 ,0,1,0,2,0,3
9223,B4GALT7 ,0,1,3,0,0,4
9224,TMEM129 ,0,1,5,0,0,6
9233,NUP43 ,4,0,0,1,0,5
9235,MOSPD2 ,2,0,0,1,0,3
9247,PLPP3 ,4,0,2,0,0,6
9256,CCNF ,0,0,2,1,0,3
9257,HSPA14 ,5,0,1,1,0,7
9269,OR10J1 ,0,0,1,1,0,2
9277,COBLL1 ,2,0,0,5,0,7
9291,DPP4 ,1,0,3,2,0,6
9294,DDX41 ,0,0,4,1,0,5
9310,TUBA8 ,2,0,0,4,0,6
9330,STX6 ,0,0,2,1,0,3
9334,SEPTIN3 ,7,0,0,1,0,8
9335,CCR2 ,0,2,1,0,0,3
9358,FADS3 ,0,0,1,1,0,2
9391,SUCLA2 ,2,1,0,0,0,3
9397,TUBB4B ,4,0,0,1,0,5
9406,HHIP ,0,0,2,1,0,3
9418,COPS7B ,0,0,4,2,0,6
9421,SDHAF2 ,1,0,0,1,0,2
9424,LEP ,0,1,1,0,0,2
9430,MTTP ,0,1,0,3,0,4
9436,MIOS ,3,0,1,0,0,4
9454,MGAT4C ,0,1,0,2,0,3
9459,EGR3 ,0,0,2,1,0,3
9471,KDM5B ,0,1,2,0,0,3
9474,SETDB1 ,0,1,0,6,0,7
9475,RXRG ,0,1,2,0,0,3
9479,DNAAF2 ,0,0,4,1,0,5
9496,STK3 ,0,0,4,2,0,6
9497,MMUT ,0,1,2,0,0,3
9498,CPA1 ,3,0,1,0,0,4
9518,SLC6A9 ,4,0,1,0,0,5
9526,SOX10 ,0,1,0,4,0,5
9531,TMEM53 ,0,0,1,3,0,4
9534,CCT3 ,5,1,0,0,0,6
9538,RASGRP2 ,0,0,3,3,0,6
9552,CEP192 ,3,0,0,1,0,4
9559,SLC23A2 ,0,0,1,1,0,2
9592,TBRG4 ,0,1,0,2,0,3
9600,NDST3 ,0,0,2,1,0,3
9601,RUNX1 ,0,1,0,4,0,5
9608,TFF2 ,1,0,0,1,0,2
9623,OARD1 ,2,0,0,1,0,3
9626,ACP7 ,0,0,1,1,0,2
9661,TDRP ,0,1,0,2,0,3
9666,PPP4C ,0,1,0,1,0,2
9671,STK10 ,0,0,2,2,0,4
9679,TOP2A ,0,1,1,0,0,2
9684,MBL2 ,1,0,0,2,0,3
9710,DENND5B ,3,0,0,1,0,4
9712,ODAM ,0,1,2,0,0,3
9719,VAPB ,0,0,1,4,0,5
9721,MAOA ,6,1,0,0,0,7
9726,ALOX15 ,1,0,5,1,0,7
9733,GALNS ,0,1,2,0,0,3
9742,PHF20L1 ,4,0,0,1,0,5
9746,RGN ,2,1,1,0,0,4
9752,ABCA8 ,5,0,0,1,0,6
9764,SIN3A ,3,0,0,1,0,4
9768,SPEF2 ,0,1,0,4,0,5
9772,NR4A2 ,0,0,1,1,0,2
9783,APC ,0,0,8,1,0,9
9803,IL21 ,0,1,2,0,0,3
9805,PLBD1 ,2,0,2,0,0,4
9808,HACE1 ,4,0,0,1,0,5
9812,STC1 ,0,1,1,0,0,2
9819,RBP2 ,2,1,0,0,0,3
9830,KIAA0319L ,0,1,0,2,0,3
9834,ANKRD28 ,7,0,0,1,0,8
9836,IGFBP4 ,1,1,0,0,0,2
9838,ACTC1 ,1,0,3,0,0,4
9847,CH25H ,0,1,0,2,0,3
9865,MRAP2 ,0,1,1,0,0,2
9869,IMPA1 ,0,1,4,0,0,5
9881,SRSF10 ,2,0,0,1,0,3
9883,DHX30 ,7,0,0,1,0,8
9891,RBM4B ,2,1,0,0,0,3
9892,PIK3R5 ,1,0,0,3,0,4
9893,SUMF2 ,2,0,1,0,0,3
9908,AFF1 ,0,0,2,2,0,4
9913,IL6 ,0,1,2,0,0,3
9915,ZC3H18 ,0,1,0,2,0,3
9916,ORC6 ,0,0,2,1,0,3
9923,SHFL ,1,0,1,0,0,2
9929,MAPKAPK3 ,0,1,1,0,0,2
9930,DUOX2 ,1,0,3,0,0,4
9933,ATP6AP1 ,0,1,2,0,0,3
9958,DHFR ,1,0,2,0,0,3
9966,SNCA ,5,1,0,0,0,6
9968,PRKACA ,1,0,3,0,0,4
9983,LOC100620900 ,1,0,2,0,0,3
9987,RBM12B ,2,0,0,1,0,3
9996,NR1I3 ,0,2,1,3,0,6
10003,HMGN2 ,1,0,3,0,0,4
10009,EEF1G ,0,1,0,1,0,2
10012,CSF1R ,0,0,4,1,0,5
10016,TMEM237 ,4,0,2,0,0,6
10029,MT3 ,1,1,0,0,0,2
10036,MRPS18A ,1,0,0,3,0,4
10040,GCGR ,0,0,1,2,0,3
10043,HTR1D ,0,1,1,0,0,2
10061,PLIN5 ,3,1,2,0,0,6
10065,LOC102161784 ,4,0,6,0,0,10
10071,HOXA9 ,0,0,1,1,0,2
10072,NECAP1 ,7,0,0,2,0,9
10090,IBSP ,1,0,0,2,0,3
10094,TREM1 ,0,1,0,2,0,3
10126,CA11 ,0,1,1,0,0,2
10132,STMN4 ,1,0,3,0,0,4
10145,PAPOLA ,0,0,3,1,0,4
10146,PID1 ,0,1,0,2,0,3
10157,LHB ,1,0,1,1,0,3
10166,THOP1 ,6,1,0,0,0,7
10167,MAPRE2 ,6,0,0,1,0,7
10181,SLC37A3 ,0,0,6,1,0,7
10185,GPATCH11 ,0,0,2,1,0,3
10192,SH3PXD2A ,0,0,3,6,0,9
10201,ELF5 ,0,0,2,1,0,3
10213,DNASE2 ,1,0,1,0,0,2
10227,SLC5A8 ,0,1,1,0,0,2
10229,CDK19 ,0,0,1,5,0,6
10235,APAF1 ,0,1,0,4,0,5
10248,BABAM1 ,0,0,1,1,0,2
10263,VEGFA ,0,1,5,0,0,6
10272,CSNK2B ,5,1,0,1,0,7
10305,AAK1 ,0,1,0,8,0,9
10307,TOMM34 ,1,0,0,1,0,2
10308,C11ORF1 ,4,0,0,4,0,8
10316,PLEKHA5 ,9,0,0,1,0,10
10325,MRPL42 ,1,0,2,0,0,3
10328,AMH ,3,1,1,0,0,5
10339,RPS16 ,1,0,1,1,0,3
10349,SNRPA ,1,0,1,0,0,2
10352,POLR1D ,0,0,1,1,0,2
10354,LOC100518860 ,4,0,0,1,0,5
10379,BABAM2 ,3,0,1,0,0,4
10380,APTX ,0,1,0,7,0,8
10383,TGFA ,0,1,0,1,0,2
10398,PRSS16 ,0,0,1,1,0,2
10399,DPP6 ,6,0,0,3,0,9
10400,SLC25A16 ,0,1,1,0,0,2
10418,SPATA20 ,3,0,0,1,0,4
10426,SLC30A4 ,0,1,1,0,0,2
10429,LPIN1 ,0,0,7,1,0,8
10435,GTPBP3 ,0,0,2,1,0,3
10447,FTSJ1 ,0,0,4,1,0,5
10449,SCOC ,3,0,1,0,0,4
10451,ATP5MF ,1,0,2,0,0,3
10456,ADAL ,2,0,0,1,0,3
10466,GNA11 ,0,1,2,0,0,3
10519,STAT2 ,1,1,0,0,0,2
10543,IDH3A ,2,0,0,1,0,3
10546,AOC1 ,1,0,1,0,0,2
10565,RAD51 ,0,1,0,1,0,2
10574,OTUD6B ,3,0,0,1,0,4
10577,DSG1 ,0,1,0,1,0,2
10603,RPS15 ,1,0,2,0,0,3
10613,NME6 ,0,0,2,1,0,3
10615,ZC3H14 ,5,0,1,0,0,6
10625,STK33 ,0,0,1,2,0,3
10628,PCK1 ,1,0,1,1,0,3
10629,ACP5 ,1,0,0,1,0,2
10642,EIF1 ,1,0,1,0,0,2
10643,PLG ,5,0,1,1,0,7
10661,ADSS2 ,0,1,1,0,0,2
10677,PTPRM ,0,0,6,1,0,7
10692,DAO ,1,0,3,0,0,4
10694,CA3 ,0,1,2,0,0,3
10697,ASXL1 ,0,0,3,1,0,4
10701,GALP ,1,0,1,0,0,2
10709,KAT8 ,0,1,1,0,0,2
10721,WWP2 ,4,0,0,2,0,6
10732,PAQR8 ,0,1,3,0,0,4
10738,PCDH1 ,2,0,0,1,0,3
10739,TRIM10 ,0,0,2,1,0,3
10750,UBE2A ,0,0,3,1,0,4
10783,TINAG ,0,0,3,1,0,4
10784,LOC100739508 ,5,0,1,0,0,6
10792,PET100 ,0,0,1,3,0,4
10810,GHRH ,1,1,0,0,0,2
10811,RPN1 ,1,0,4,0,0,5
10827,AP5Z1 ,3,0,0,1,0,4
10833,STK32B ,0,0,2,2,0,4
10839,PRM1 ,1,0,1,0,0,2
10840,CNOT10 ,7,0,1,0,0,8
10843,AADACL2 ,0,0,1,1,0,2
10848,IRF3 ,1,0,0,2,0,3
10851,HTR2B ,0,1,1,0,0,2
10863,MYO7A ,0,1,3,0,0,4
10869,VDAC1 ,3,1,0,0,0,4
10870,MX1 ,1,1,0,1,0,3
10872,THPO ,1,0,2,0,0,3
10875,EPHX1 ,0,1,1,0,0,2
10876,ARHGDIA ,0,1,2,0,0,3
10880,DUS3L ,0,0,2,3,0,5
10882,TFAM ,1,1,0,0,0,2
10885,NR4A3 ,0,2,1,0,0,3
10888,PSME4 ,0,0,2,1,0,3
10913,CIITA ,0,1,0,8,0,9
10918,STK4 ,0,0,3,3,0,6
10921,AASDH ,0,0,3,1,0,4
10926,CEP20 ,0,0,4,1,0,5
10927,DUSP16 ,0,0,2,1,0,3
10929,STK17B ,0,0,1,1,0,2
10935,SPRTN ,0,0,1,1,0,2
10951,SLC22A1 ,0,1,3,1,0,5
10964,SESTD1 ,8,0,0,1,0,9
10969,ESD ,2,1,0,0,0,3
10970,CDKL2 ,0,0,1,2,0,3
10976,SH3PXD2B ,0,0,2,1,0,3
10985,ATG12 ,0,1,0,1,0,2
11012,GALM ,0,1,2,3,0,6
11014,ZFP36 ,0,1,0,1,0,2
11024,MAEL ,0,1,3,0,0,4
11025,INTS11 ,6,0,0,1,0,7
11028,SPP2 ,0,1,1,0,0,2
11033,CBWD1 ,0,0,4,1,0,5
11035,SLC16A1 ,3,0,2,0,0,5
11040,CCNB2 ,0,1,2,0,0,3
11057,ADAM10 ,5,1,0,0,0,6
11070,PRKAG1 ,1,0,2,0,0,3
11099,CSN1S1 ,0,1,3,0,0,4
11104,IQCG ,0,0,1,1,0,2
11109,CHFR ,0,0,4,1,0,5
11120,LOC100512795 ,5,0,1,0,0,6
11122,MSANTD3-TMEFF1 ,0,0,2,2,0,4
11133,MDM2 ,0,0,8,2,0,10
11141,TTR ,1,0,3,0,0,4
11170,BRF1 ,0,0,2,1,0,3
11176,MT-CO2 ,1,0,1,0,0,2
11179,PRLR ,0,1,6,0,0,7
11183,LOC100523609 ,0,0,5,4,0,9
11192,PSMB7 ,1,1,0,0,0,2
11211,NOS2 ,0,1,6,0,0,7
11213,ACADS ,4,1,1,0,0,6
11239,NT5C2 ,7,0,1,1,0,9
11242,COPS4 ,3,1,0,0,0,4
11244,SCML2 ,0,0,2,1,0,3
11251,GREM1 ,0,0,1,1,0,2
11256,HMGB1 ,3,1,0,0,0,4
11259,ACTB ,1,0,2,0,0,3
11275,ALDH9A1 ,1,1,0,0,0,2
11282,AK1 ,1,0,2,0,0,3
11287,ILDR2 ,0,0,5,4,0,9
11295,RPS20 ,1,0,1,1,0,3
11320,PRODH2 ,0,0,2,1,0,3
11328,FBXL4 ,0,1,0,1,0,2
11329,PCYT1A ,4,0,1,0,0,5
11344,SAMD11 ,3,0,0,1,0,4
11384,LIN7B ,2,0,0,1,0,3
11386,PTI ,5,0,0,1,0,6
11404,RRM2B ,0,0,3,1,0,4
11405,ACTA1 ,1,0,3,0,0,4
11430,THOC5 ,0,1,4,0,0,5
11432,GGH ,3,0,0,1,0,4
11433,TYW3 ,0,1,2,0,0,3
11461,IL4R ,0,1,2,0,0,3
11481,TXN ,1,0,1,3,0,5
11484,IREB2 ,0,1,1,0,0,2
11492,OSBPL7 ,0,0,1,1,0,2
11503,FCN1 ,1,0,2,3,0,6
11524,ANGPT2 ,0,1,0,2,0,3
11541,LDLR ,0,1,0,7,0,8
11543,NPPA ,1,0,2,0,0,3
11544,PSMB2 ,2,0,1,0,0,3
11547,GPNMB ,3,0,0,1,0,4
11548,PPP2R1B ,0,1,0,5,0,6
11556,MAGED1 ,0,1,0,1,0,2
11563,CCK ,1,0,1,0,0,2
11564,EVPL ,1,0,0,1,0,2
11574,NFATC1 ,0,1,0,9,0,10
11577,SAR1A ,1,1,0,0,0,2
11581,TAX1BP3 ,2,0,0,1,0,3
11582,BMPR2 ,0,1,4,0,0,5
11591,SCG5 ,1,0,3,0,0,4
11597,IL12A ,0,1,1,0,0,2
11631,CCDC93 ,7,0,1,0,0,8
11647,HACL1 ,8,0,0,2,0,10
11649,CCL17 ,0,1,2,0,0,3
11664,DHX58 ,0,0,2,1,0,3
11669,VPS8 ,0,0,4,2,0,6
11672,VRTN ,0,1,1,0,0,2
11685,HBE1 ,1,0,1,0,0,2
11696,DMD ,1,0,0,7,0,8
11699,SARM1 ,0,1,1,0,0,2
11702,PIP4K2A ,0,1,0,2,0,3
11728,DUOX1 ,0,1,2,0,0,3
11729,CILP ,1,0,0,3,0,4
11760,CLK1 ,0,2,0,2,0,4
11774,USP2 ,0,0,3,3,0,6
11776,ADCYAP1 ,1,0,1,0,0,2
11782,TMEM59 ,3,1,1,0,0,5
11853,SLC22A6 ,1,0,0,2,0,3
11855,HSPA12A ,6,0,0,1,0,7
11866,DOCK4 ,5,0,1,0,0,6
11900,TRPC1 ,0,0,1,1,0,2
11903,KDM4C ,0,0,4,1,0,5
11913,CCDC60 ,2,0,1,2,0,5
11915,SFTPA1 ,0,1,0,2,0,3
11921,SETD3 ,4,0,1,1,0,6
11935,ZMYND10 ,0,0,1,2,0,3
11943,EIF2D ,0,0,6,1,0,7
11946,POU2F1 ,0,1,7,0,0,8
11952,TARBP2 ,0,0,2,3,0,5
11955,DAB1 ,0,1,0,5,0,6
11958,PTBP1 ,5,1,0,2,0,8
11962,TYK2 ,0,0,1,1,0,2
11969,CLIC1 ,0,1,2,0,0,3
11974,ENSA ,1,0,3,0,0,4
11987,YIPF5 ,0,1,0,2,0,3
11990,EFNA1 ,0,1,2,0,0,3
12009,SLA-DQA1 ,0,1,0,3,0,4
12010,DIP2A ,0,0,1,1,0,2
12016,USP36 ,0,0,1,1,0,2
12023,BHMT ,10,1,0,0,0,11
12026,MICOS13 ,1,0,1,0,0,2
12034,KRT20 ,3,1,0,0,0,4
12039,DLX3 ,0,0,1,1,0,2
12043,PDS5A ,2,0,1,0,0,3
12047,FOLH1B ,2,0,1,0,0,3
12049,TXNRD1 ,7,1,0,0,0,8
12059,ITPR2 ,0,0,3,1,0,4
12084,NDST1 ,0,1,1,0,0,2
12086,SRY ,0,1,1,0,0,2
12087,ZFPM2 ,0,1,0,3,0,4
12097,RPAP1 ,0,0,5,1,0,6
12098,LSM14A ,0,1,2,0,0,3
12107,SPG7 ,0,0,3,1,0,4
12117,INPP5J ,0,0,2,2,0,4
12131,PPP2CB ,0,1,2,1,0,4
12139,TBPL1 ,1,0,1,0,0,2
12153,COX18 ,0,0,1,1,0,2
12157,SLC28A1 ,0,1,5,0,0,6
12195,GKN3 ,0,1,0,1,0,2
12197,MTG1 ,0,0,2,1,0,3
12198,BPIFB1 ,0,1,0,1,0,2
12202,APOA4 ,2,1,0,0,0,3
12214,PTHLH ,0,1,1,0,0,2
12215,NCBP2 ,1,0,1,0,0,2
12222,PSME3 ,4,1,0,0,0,5
12230,ARID4B ,3,0,0,2,0,5
12257,FTCD ,1,0,1,0,0,2
12275,URGCP ,0,0,2,1,0,3
12281,RABEP1 ,0,0,4,1,0,5
12283,PNLIPRP2 ,1,0,2,0,0,3
12287,CDC20 ,0,1,1,0,0,2
12288,STBD1 ,2,0,4,0,0,6
12290,INKA2 ,0,0,2,1,0,3
12303,MEF2D ,2,0,0,5,0,7
12306,UIMC1 ,1,0,1,1,0,3
12307,NOL11 ,4,0,0,1,0,5
12333,CLDN18 ,0,1,1,0,0,2
12339,PGAP1 ,7,0,1,0,0,8
12345,CYTH1 ,0,1,0,5,0,6
12348,SUV39H2 ,0,1,2,0,0,3
12356,RAD9A ,0,0,1,1,0,2
12389,TSPO ,1,1,1,0,0,3
12416,OSTN ,0,1,0,1,0,2
12422,DYNLRB2 ,0,0,1,1,0,2
12424,AMN ,1,0,0,2,0,3
12427,PPARGC1A ,0,1,0,6,0,7
12447,STUM ,3,0,0,1,0,4
12450,BCAT2 ,9,1,0,0,0,10
12451,LDHB ,2,0,2,0,0,4
12455,DNAAF5 ,1,0,0,1,0,2
12458,PKN2 ,0,0,1,1,0,2
12472,HPCAL1 ,0,1,0,1,0,2
12475,CDSN ,0,0,1,1,0,2
12476,MRPS10 ,1,0,1,0,0,2
12487,PPP2R1A ,0,1,0,4,0,5
12493,GPR39 ,0,1,1,0,0,2
12495,GSS ,3,0,0,1,0,4
12500,PNPLA2 ,0,1,0,1,0,2
12506,ATP6V1H ,0,1,5,0,0,6
12519,SLC35D2 ,0,1,0,4,0,5
12534,CD72 ,0,1,0,3,0,4
12535,GAD1 ,0,1,3,1,0,5
12545,UBE2E2 ,0,0,1,2,0,3
12551,EMC8 ,0,0,3,1,0,4
12587,GCDH ,1,0,3,0,0,4
12603,FGFR1 ,0,0,3,1,0,4
12606,GPT ,2,0,0,1,0,3
12621,RAMP1 ,0,1,2,0,0,3
12626,ESRRA ,0,0,1,1,0,2
12630,PSMC5 ,0,1,4,0,0,5
12631,TRIM7 ,0,1,0,1,0,2
12636,LEPR ,0,1,4,0,0,5
12651,IVD ,3,0,0,3,0,6
12654,TPI1 ,3,1,0,0,0,4
12661,SUMO2 ,0,0,2,1,0,3
12672,GUK1 ,1,0,3,1,0,5
12691,FITM1 ,0,1,0,1,0,2
12703,DUSP13 ,2,0,3,0,0,5
12722,RAB40B ,0,1,0,9,0,10
12726,OAZ3 ,0,1,1,0,0,2
12730,CDK2 ,4,0,3,0,0,7
12749,AVP ,1,0,2,0,0,3
12753,FCHO2 ,0,0,6,2,0,8
12754,HOXA10 ,0,2,0,2,0,4
12756,XRN1 ,0,0,2,1,0,3
12763,NTRK2 ,0,0,4,2,0,6
12772,CASR ,0,2,0,1,0,3
12776,SLC7A2 ,0,1,3,0,0,4
12787,ATAT1 ,5,0,2,0,0,7
12801,RHOF ,0,1,0,4,0,5
12813,SMYD2 ,0,1,0,1,0,2
12814,IMMP2L ,0,0,2,2,0,4
12816,SMIM13 ,1,0,0,1,0,2
12820,PISD ,0,0,4,2,0,6
12827,TRNAU1AP ,0,0,1,1,0,2
12828,RBM14 ,3,0,0,1,0,4
12838,PSEN2 ,1,0,6,0,0,7
12852,UCHL3 ,6,1,0,0,0,7
12855,SLC20A1 ,0,1,1,0,0,2
12863,SYS1 ,0,0,1,1,0,2
12904,CPNE8 ,0,0,2,1,0,3
12909,PLAU ,0,1,0,3,0,4
12914,PPP1R18 ,0,0,1,3,0,4
12915,CGA ,1,0,2,0,0,3
12918,OCRL ,5,0,1,0,0,6
12937,SERINC3 ,0,1,1,0,0,2
12949,GLTP ,2,0,0,1,0,3
12965,MYLK4 ,0,0,2,2,0,4
12990,OSBPL2 ,0,1,7,0,0,8
12991,CARTPT ,1,1,0,0,0,2
12994,CDK14 ,0,0,2,2,0,4
13026,ITPRIPL1 ,0,1,1,0,0,2
13030,SINHCAF ,0,1,0,4,0,5
13035,FOS ,0,0,4,1,0,5
13042,GNMT ,0,1,1,1,0,3
13044,SAAL1 ,0,0,1,5,0,6
13045,SLC26A11 ,0,0,1,1,0,2
13062,MEF2C ,0,1,0,4,0,5
13065,PPM1L ,0,0,1,3,0,4
13080,LOC110255845 ,1,0,0,1,0,2
13107,SPATA17 ,0,1,0,1,0,2
13119,NR2C1 ,0,0,1,3,0,4
13138,SUMO1 ,0,0,3,4,0,7
13139,MPPED2 ,0,0,1,2,0,3
13161,SH3BGRL2 ,1,0,1,0,0,2
13168,MIX23 ,2,0,2,0,0,4
13171,PMP2 ,1,0,2,1,0,4
13174,PAQR9 ,0,0,1,1,0,2
13187,VMP1 ,6,0,0,1,0,7
13189,RAMP3 ,0,1,2,0,0,3
13192,LOC102166958 ,0,0,4,1,0,5
13199,SRD5A2 ,0,1,1,0,0,2
13209,KLF13 ,0,1,0,1,0,2
13220,RPS19 ,1,1,1,0,0,3
13222,KDSR ,4,0,1,0,0,5
13234,CD9 ,3,1,0,0,0,4
13241,NDUFB6 ,3,1,0,0,0,4
13249,TRIM26 ,0,0,1,2,0,3
13254,IDH2 ,1,0,3,0,0,4
13256,SUV39H1 ,0,0,3,1,0,4
13261,GTF2H2 ,0,0,2,1,0,3
13264,DTNBP1 ,0,1,5,0,0,6
13265,SNX7 ,0,0,4,1,0,5
13273,SLC13A3 ,0,0,2,1,0,3
13287,TMA16 ,1,0,0,1,0,2
13324,RPS29 ,3,0,1,0,0,4
13334,PIWIL4 ,0,1,3,1,0,5
13337,GIPC1 ,0,0,2,1,0,3
13347,APBB1 ,4,0,0,1,0,5
13349,WEE2 ,1,0,2,0,0,3
13368,IL1A ,0,1,2,0,0,3
13376,TASOR ,0,0,3,1,0,4
13381,MRPS15 ,1,0,1,0,0,2
13387,CCNG1 ,0,1,0,1,0,2
13390,B4GALT5 ,1,0,2,0,0,3
13398,TUBB ,2,1,0,0,0,3
13399,SPG11 ,0,0,1,3,0,4
13406,ARHGAP33 ,0,0,2,5,0,7
13415,NCOA1 ,0,1,5,0,0,6
13416,PFKFB1 ,0,1,9,0,0,10
13419,LGALS1 ,4,1,0,0,0,5
13425,POMT2 ,2,0,0,2,0,4
13431,SMAD2 ,0,1,3,0,0,4
13438,FKBP11 ,3,0,1,2,0,6
13453,REXO2 ,3,0,0,2,0,5
13455,PTGES ,1,1,0,0,0,2
13470,CKM ,3,1,0,0,0,4
13484,EDNRB ,0,1,2,0,0,3
13488,CPEB4 ,0,0,2,2,0,4
13489,MRPL30 ,1,0,1,0,0,2
13494,TNFSF14 ,0,1,2,0,0,3
13503,NR0B1 ,0,1,1,0,0,2
13517,KIF1A ,5,0,0,1,0,6
13518,WWOX ,0,0,1,3,0,4
13527,OTC ,2,1,0,0,0,3
13549,ANKRD1 ,0,3,0,1,0,4
13552,ASGR2 ,2,0,0,1,0,3
13567,RABGGTA ,1,1,0,0,0,2
13583,GATA6 ,0,1,0,1,0,2
13613,DLK2 ,0,1,0,1,0,2
13615,TRAF2 ,0,0,1,1,0,2
13616,TSPAN31 ,0,1,2,2,0,5
13638,E2F3 ,0,0,4,1,0,5
13665,SRSF1 ,3,1,0,0,0,4
13666,KCNH2 ,0,1,1,2,0,4
13674,MVB12A ,0,0,1,1,0,2
13684,PHGDH ,4,0,1,0,0,5
13685,CRP ,3,1,3,1,0,8
13690,ELAC1 ,0,0,1,1,0,2
13697,MMP17 ,0,0,1,1,0,2
13703,AKIRIN2 ,0,1,2,0,0,3
13707,NR1I2 ,0,0,4,3,0,7
13728,DPYD ,1,0,2,0,0,3
13751,ING4 ,0,0,1,3,0,4
13755,GTF2H1 ,5,0,0,1,0,6
13777,TTL ,1,0,0,2,0,3
13786,RPL13A ,1,1,0,0,0,2
13798,VDAC2 ,0,1,2,0,0,3
13807,MASTL ,0,0,3,2,0,5
13809,TPM3 ,9,1,0,0,0,10
13816,HOXB8 ,0,0,1,1,0,2
13825,ITGB1BP2 ,0,1,0,1,0,2
13833,CAMTA1 ,0,0,3,2,0,5
13835,AQN-1 ,0,1,2,0,0,3
13839,GAS7 ,0,1,0,3,0,4
13841,RAB27A ,1,1,0,0,0,2
13843,GADD45A ,0,0,2,1,0,3
13852,AKAP8L ,4,0,0,1,0,5
13859,PUS7 ,0,0,5,5,0,10
13860,OSTF1 ,4,1,0,0,0,5
13883,IRAK4 ,0,0,1,1,0,2
13902,PTK6 ,0,0,1,1,0,2
13922,RPS6KA2 ,4,0,6,0,0,10
13941,PTTG1 ,0,1,1,0,0,2
13943,EFS ,0,0,2,1,0,3
13944,STAT5A ,0,1,3,0,0,4
13971,CPB1 ,1,0,1,0,0,2
13974,IL7 ,0,1,5,0,0,6
13980,INPPL1 ,1,0,2,1,0,4
13982,RPP30 ,3,0,1,0,0,4
13988,BRCC3 ,4,0,1,0,0,5
13989,LTN1 ,3,0,0,1,0,4
13991,MRPL32 ,1,0,0,2,0,3
14000,CBLN3 ,0,1,0,1,0,2
14002,HSPB1 ,0,1,2,0,0,3
14009,KLF17 ,0,1,0,1,0,2
14023,LRRC42 ,0,0,1,1,0,2
14027,NCOA3 ,0,0,1,1,0,2
14033,COQ4 ,0,0,1,1,0,2
14051,QDPR ,0,1,0,3,0,4
14052,MAP4K1 ,0,0,2,1,0,3
14055,PIK3CB ,0,1,3,0,0,4
14071,NTAN1 ,1,0,0,4,0,5
14072,ANG ,1,0,5,0,0,6
14074,NPY ,1,0,2,0,0,3
14095,SEMA3D ,0,0,4,1,0,5
14105,ADGRG7 ,4,0,0,1,0,5
14106,AFAP1 ,4,0,0,1,0,5
14109,NAAA ,4,0,1,0,0,5
14114,NCK2 ,1,0,0,1,0,2
14118,SLC11A1 ,0,1,2,0,0,3
14120,KCNQ1 ,0,1,2,0,0,3
14121,GJA1 ,0,1,1,0,0,2
14123,GRB10 ,0,1,1,1,0,3
14128,BECN1 ,1,0,3,0,0,4
14146,SLC15A4 ,0,1,1,0,0,2
14148,ATP5ME ,1,0,1,0,0,2
14159,DCAF6 ,5,0,0,3,0,8
14168,MBTPS2 ,0,0,4,3,0,7
14184,NTHL1 ,0,0,1,1,0,2
14186,ABHD5 ,0,1,0,2,0,3
14192,PDK3 ,6,0,1,0,0,7
14204,YTHDF2 ,0,1,0,3,0,4
14215,INHBB ,1,0,1,0,0,2
14222,PRELID3B ,0,0,1,1,0,2
14246,CCNL2 ,0,0,1,3,0,4
14249,DEFB1 ,0,1,1,0,0,2
14259,NDUFAF6 ,1,0,0,1,0,2
14265,ADRB1 ,0,1,1,0,0,2
14273,CD247 ,0,1,2,0,0,3
14274,SPAST ,0,1,3,1,0,5
14275,MIOX ,1,0,3,0,0,4
14284,DDX39A ,2,0,0,2,0,4
14315,CAMTA2 ,0,0,5,1,0,6
14319,ACTA2 ,0,1,5,0,0,6
14335,MAST2 ,0,0,3,1,0,4
14341,STAG1 ,0,1,6,0,0,7
14345,IRAK2 ,0,0,3,1,0,4
14351,AP1S2 ,1,0,4,0,0,5
14358,ATP9A ,7,0,1,2,0,10
14359,AFP ,1,1,0,0,0,2
14362,FSHR ,0,1,2,0,0,3
14365,GRM7 ,5,0,0,1,0,6
14376,SRGAP3 ,2,0,0,1,0,3
14393,NR2F2 ,0,1,1,0,0,2
14414,ZEB2 ,0,0,6,1,0,7
14415,ASPA ,0,1,3,0,0,4
14416,PLP1 ,0,1,4,0,0,5
14422,HTRA1 ,1,0,1,0,0,2
14433,CELA2A ,1,0,0,1,0,2
14434,GOSR2 ,9,0,0,1,0,10
14443,ATF7 ,0,0,3,1,0,4
14475,LOC110257686 ,0,0,1,2,0,3
14478,DDB2 ,0,0,3,1,0,4
14480,ARL3 ,0,1,5,0,0,6
14481,ST6GALNAC2 ,0,0,2,1,0,3
14490,KIF6 ,0,0,1,2,0,3
14501,ANKFY1 ,4,0,2,0,0,6
14506,PLPP2 ,0,2,1,0,0,3
14513,ATP9B ,0,0,2,1,0,3
14524,LOC110255214 ,0,0,2,1,0,3
14527,TMEM268 ,2,0,1,1,0,4
14528,CSNK1A1 ,6,1,0,0,0,7
14538,RAB34 ,2,1,0,2,0,5
14540,SDR16C5 ,0,1,1,1,0,3
14553,PTK7 ,5,0,0,1,0,6
14554,MAX ,0,0,5,1,0,6
14568,RPS13 ,1,1,0,0,0,2
14584,RAB14 ,0,1,0,1,0,2
14585,ASF1B ,0,1,1,0,0,2
14591,PALM ,0,1,3,0,0,4
14603,ITM2B ,0,2,3,0,0,5
14618,CCNB3 ,0,0,4,1,0,5
14628,NRXN3 ,7,0,0,3,0,10
14639,ST3GAL1 ,1,0,1,0,0,2
14652,OXTR ,0,1,1,0,0,2
14662,CCL1 ,0,1,1,0,0,2
14673,DGKA ,1,0,3,0,0,4
14690,REG3G ,0,1,0,1,0,2
14691,ALOX5AP ,1,1,0,0,0,2
14694,LOC102162880 ,1,0,1,0,0,2
14707,PPP1R14B ,1,1,1,0,0,3
14708,PDYN ,1,0,1,0,0,2
14718,DDO ,0,1,3,0,0,4
14726,HPSE ,0,0,3,1,0,4
14729,ISCA1 ,1,0,0,1,0,2
14734,RHCG ,0,1,1,0,0,2
14754,LY96 ,0,1,0,1,0,2
14755,CHGB ,1,0,2,0,0,3
14762,LHX3 ,0,1,0,2,0,3
14763,PLET1 ,0,1,0,1,0,2
14765,GRB14 ,0,0,2,1,0,3
14813,MAPK13 ,0,0,1,3,0,4
14816,FAM3D ,2,0,0,2,0,4
14821,MAP3K7 ,0,2,2,0,0,4
14823,RPS9 ,1,1,1,0,0,3
14829,RBM42 ,5,0,0,2,0,7
14831,DPF1 ,0,0,5,1,0,6
14833,CALN1 ,0,0,4,4,0,8
14837,TRAF3 ,0,1,2,0,0,3
14843,ABCC4 ,4,0,1,1,0,6
14845,ARFGAP2 ,4,0,0,1,0,5
14855,CDK10 ,0,0,2,3,0,5
14857,ATXN3L ,0,1,0,9,0,10
14866,KIT ,0,2,2,0,0,4
14894,ZRANB2 ,0,1,2,0,0,3
14895,NEBL ,6,0,0,2,0,8
14896,DHX38 ,0,1,0,3,0,4
14918,GPX1 ,0,1,1,0,0,2
14934,MFSD1 ,0,1,0,2,0,3
14952,IPO4 ,2,0,0,3,0,5
14955,PSMD2 ,4,0,0,2,0,6
14957,CPT1B ,2,1,2,0,0,5
14962,TK2 ,0,0,1,1,0,2
14964,KISS1R ,0,1,0,1,0,2
14966,U2AF1 ,0,1,0,3,0,4
14970,LOC110259328 ,1,0,3,0,0,4
14975,WDR62 ,0,0,1,1,0,2
14976,IDUA ,0,1,2,0,0,3
14987,NR5A1 ,0,1,1,0,0,2
14992,SRP19 ,3,0,0,1,0,4
15007,CSTF3 ,2,0,0,1,0,3
15017,NAMPT ,3,2,1,0,0,6
15018,EEF1D ,4,0,4,0,0,8
15029,TPO ,1,0,3,1,0,5
15035,NAXE ,2,1,0,0,0,3
15039,TMIGD3 ,0,0,3,2,0,5
15040,SCAF11 ,4,0,0,1,0,5
15042,SLC6A11 ,3,0,0,1,0,4
15045,EP400 ,2,0,0,1,0,3
15053,NOL4L ,2,0,0,4,0,6
15064,GPR83 ,0,0,1,1,0,2
15070,SIM1 ,0,1,0,2,0,3
15071,PKD2 ,0,1,1,0,0,2
15074,SLC46A3 ,0,1,0,1,0,2
15084,KMO ,0,1,3,1,0,5
15093,KDM2B ,0,0,3,5,0,8
15094,FTO ,0,1,2,2,0,5
15100,MGARP ,1,0,0,1,0,2
15104,FZR1 ,0,1,3,1,0,5
15129,ZMYND8 ,9,0,0,1,0,10
15157,MYL6B ,4,0,0,3,0,7
15161,KCNE1 ,0,1,1,0,0,2
15163,TMEM159 ,1,0,2,0,0,3
15175,CRYZ ,0,2,1,1,0,4
15177,ADGRD1 ,0,0,4,2,0,6
15199,PIEZO2 ,0,0,5,1,0,6
15201,LDB2 ,0,0,1,4,0,5
15213,CD28 ,0,1,0,2,0,3
15244,POLR2E ,1,0,2,0,0,3
15245,MASP1 ,0,2,0,2,0,4
15264,MDH2 ,1,0,2,0,0,3
15271,HJV ,0,0,1,1,0,2
15275,NO NAME,169,14,554,2848,0,3585
15276,MYH4 ,2,1,5,0,0,8
15287,ARL9 ,0,0,1,1,0,2
15296,STAT5B ,0,2,1,0,0,3
15307,F8 ,1,0,1,0,0,2
15327,TRAK2 ,0,0,2,1,0,3
15332,NUDT7 ,0,0,3,1,0,4
15337,ITM2C ,3,1,0,0,0,4
15349,HTR4 ,0,1,8,0,0,9
15366,CSF2 ,0,1,1,0,0,2
15371,CDKN3 ,0,1,2,2,0,5
15399,CACNB4 ,0,0,5,1,0,6
15402,CREB5 ,0,0,2,1,0,3
15404,ADPRM ,0,0,1,1,0,2
15415,IL10 ,0,1,1,0,0,2
15423,KITLG ,0,1,3,0,0,4
15430,PLIN3 ,4,1,0,0,0,5
15439,FBXO32 ,0,1,0,3,0,4
15443,GCA ,1,0,0,1,0,2
15464,PRPSAP2 ,5,0,4,0,0,9
15469,DAZL ,0,1,0,1,0,2
15482,STK11IP ,0,0,2,1,0,3
15488,TP53 ,0,1,1,0,0,2
15489,MTUS1 ,0,0,5,1,0,6
15491,NKRF ,0,0,1,1,0,2
15494,PRKAB1 ,1,0,2,0,0,3
15496,UBE2B ,0,1,0,1,0,2
15503,GNLY ,0,1,0,2,0,3
15523,PAX3 ,0,0,1,1,0,2
15531,PDSS2 ,0,1,2,0,0,3
15541,PRORP ,6,0,3,1,0,10
15545,VIL1 ,2,1,0,0,0,3
15593,DEPDC1B ,0,0,4,4,0,8
15594,SMYD5 ,5,0,0,1,0,6
15599,LOC100519082 ,4,0,1,0,0,5
15620,TXNIP ,1,1,0,0,0,2
15623,F2 ,0,1,1,0,0,2
15626,IMPA2 ,0,0,5,1,0,6
15628,DBI ,1,0,0,1,0,2
15654,SUCLG2 ,1,0,3,1,0,5
15665,F12 ,0,1,0,5,0,6
15669,DMRT1 ,0,1,2,0,0,3
15673,UGGT2 ,0,0,3,3,0,6
15675,MCHR1 ,0,1,0,1,0,2
15686,ARID5B ,0,0,3,1,0,4
15701,DSC2 ,3,0,0,3,0,6
15702,TRMU ,0,0,2,1,0,3
15709,AGBL4 ,0,0,2,4,0,6
15715,KAZN ,3,0,0,1,0,4
15717,TBXAS1 ,1,0,3,0,0,4
15721,THOC1 ,3,0,0,1,0,4
15731,ITGA10 ,3,0,2,0,0,5
15745,SLC45A2 ,5,1,0,3,0,9
15746,TPT1 ,2,1,0,0,0,3
15775,MNAT1 ,0,1,0,1,0,2
15778,MRPL58 ,1,0,0,1,0,2
15779,IL13 ,0,1,0,1,0,2
15784,GLUL ,2,1,0,0,0,3
15789,CYSLTR2 ,0,1,0,2,0,3
15807,RNF181 ,1,0,0,1,0,2
15815,CRIP2 ,2,0,0,1,0,3
15818,GNPDA2 ,3,0,0,1,0,4
15831,BRWD1 ,2,0,0,3,0,5
15837,ACYP2 ,1,0,4,0,0,5
15841,NDUFB2 ,1,0,3,0,0,4
15848,FUNDC2 ,1,1,0,0,0,2
15850,PPOX ,5,0,0,2,0,7
15870,PCDH15 ,1,0,0,3,0,4
15875,CD3G ,0,1,0,1,0,2
15876,TALDO1 ,2,1,0,0,0,3
15883,PTAFR ,0,1,2,0,0,3
15887,DAG1 ,4,1,0,0,0,5
15889,NCR1 ,0,1,0,1,0,2
15891,MRM1 ,3,0,0,2,0,5
15892,MET ,3,1,0,0,0,4
15897,ADAM8 ,0,1,0,1,0,2
15904,CBLN1 ,1,1,0,0,0,2
15906,RNASE1 ,1,1,1,0,0,3
15908,SLC7A8 ,1,0,1,2,0,4
15913,CD36 ,7,0,3,0,0,10
15914,CDH6 ,1,0,0,1,0,2
15915,FBN1 ,2,1,0,0,0,3
15920,HADHA ,2,1,0,0,0,3
15929,CEP57 ,0,0,3,1,0,4
15931,MRPL24 ,1,0,1,0,0,2
15933,CCNH ,0,1,3,0,0,4
15936,KLHL12 ,0,0,4,3,0,7
15938,EPHX2 ,6,1,0,1,0,8
15943,APPL1 ,0,1,0,2,0,3
15950,MCT7 ,0,1,0,1,0,2
15956,PYCR1 ,5,0,0,1,0,6
15957,NUDT16 ,1,0,0,1,0,2
15964,CLPS ,1,0,0,1,0,2
15966,IKBKB ,0,1,0,2,0,3
15970,MNDA ,0,1,0,1,0,2
15974,RPL6 ,1,0,2,0,0,3
15979,TNP2 ,0,1,1,0,0,2
15994,KLRK1 ,0,1,0,3,0,4
16002,TPK1 ,2,0,4,1,0,7
16005,ICMT ,2,0,4,0,0,6
16007,CTU1 ,0,0,1,1,0,2
16013,EIF2B4 ,0,0,1,1,0,2
16017,REG4 ,0,1,0,2,0,3
16020,GTPBP4 ,3,0,1,0,0,4
16022,SNX1 ,5,0,0,1,0,6
16041,MUC1 ,6,0,0,1,0,7
16052,PCSK2 ,0,1,2,0,0,3
16062,MMP14 ,0,1,5,0,0,6
16063,PRKAA1 ,1,0,2,0,0,3
16083,EPHA3 ,0,1,0,3,0,4
16089,GLIPR2 ,4,0,0,1,0,5
16102,USP15 ,2,0,1,1,0,4
16103,CDKAL1 ,0,0,4,2,0,6
16109,MYBPC1 ,8,0,0,1,0,9
16137,BEST1 ,1,0,2,0,0,3
16148,TLR3 ,0,2,3,0,0,5
16168,OPRM1 ,0,1,3,0,0,4
16170,HPS3 ,0,1,0,2,0,3
16172,ST6GALNAC6 ,0,0,1,1,0,2
16176,LOC100153094 ,1,0,2,0,0,3
16178,DIPK1C ,0,0,1,1,0,2
16183,CHD3 ,6,0,0,1,0,7
16199,TMEM251 ,0,1,1,0,0,2
16207,ABRA ,0,1,0,1,0,2
16208,RGS5 ,0,1,0,1,0,2
16216,MCFD2 ,3,0,0,1,0,4
16218,IGFBP1 ,0,1,1,0,0,2
16220,SMC4 ,7,0,1,0,0,8
16245,CAMK2D ,0,1,7,1,0,9
16250,PLXNC1 ,0,1,2,1,0,4
16253,ZP2 ,0,1,0,1,0,2
16256,HGF ,0,0,1,2,0,3
16257,PASK ,0,0,1,5,0,6
16268,AASDHPPT ,2,0,1,0,0,3
16291,UCHL1 ,2,1,0,0,0,3
16307,DTD1 ,2,0,1,0,0,3
16314,HTR1B ,0,1,1,0,0,2
16324,WDR18 ,0,0,1,1,0,2
16334,BBS4 ,0,0,4,1,0,5
16335,PTPRA ,4,0,1,0,0,5
16340,POLR2G ,2,0,1,0,0,3
16342,CASP1 ,7,1,0,1,0,9
16343,ZYG11B ,3,0,1,0,0,4
16361,AACS ,0,0,1,2,0,3
16371,UNC93B1 ,0,0,3,1,0,4
16372,CCL25 ,0,1,2,0,0,3
16374,FLOT1 ,1,0,1,0,0,2
16379,RPL4 ,4,1,0,0,0,5
16385,DTNA ,5,0,0,1,0,6
16393,OPRL1 ,0,1,2,0,0,3
16400,MIB1 ,0,1,0,1,0,2
16406,AQP7 ,3,0,1,0,0,4
16414,CALCB ,0,1,3,0,0,4
16418,MICAL3 ,5,0,3,0,0,8
16429,BGLAP ,1,0,1,0,0,2
16430,TMEM9B ,5,0,0,1,0,6
16440,CD34 ,2,0,0,1,0,3
16448,CHRNA1 ,0,0,2,1,0,3
16449,SNTG1 ,0,0,9,1,0,10
16456,MYCL ,0,1,0,1,0,2
16470,ITGB1 ,4,1,0,0,0,5
16480,HSPA4 ,4,0,0,2,0,6
16482,SMAD7 ,0,1,1,0,0,2
16517,SLC5A1 ,0,1,3,0,0,4
16521,DHX29 ,4,0,1,0,0,5
16524,UBE2H ,0,0,4,1,0,5
16531,CNOT1 ,1,0,0,1,0,2
16534,MYNN ,0,2,0,1,0,3
16537,B4GALNT1 ,0,0,1,3,0,4
16542,NNMT ,0,1,1,0,0,2
16548,SPAG11 ,0,1,0,3,0,4
16550,UBE2D1 ,0,1,3,0,0,4
16570,RAE1 ,1,0,1,0,0,2
16575,GABBR1 ,4,0,2,0,0,6
16578,MRPL48 ,2,0,0,1,0,3
16580,XPR1 ,0,0,2,1,0,3
16609,CACYBP ,3,0,0,1,0,4
16620,LOC100737121 ,1,0,3,0,0,4
16626,UCP3 ,0,1,2,0,0,3
16643,IQGAP1 ,1,0,0,2,0,3
16664,MAN1A1 ,1,0,2,0,0,3
16694,COG3 ,4,0,1,0,0,5
16713,CFB ,4,0,1,0,0,5
16718,LIPE ,1,1,2,0,0,4
16719,RPS6KB1 ,0,0,4,1,0,5
16729,PRKCH ,0,0,1,1,0,2
16732,RBPJ ,0,1,6,0,0,7
16735,OGFRL1 ,2,0,1,0,0,3
16738,ESR2 ,0,1,1,0,0,2
16764,GFM1 ,4,0,4,0,0,8
16769,MYSM1 ,0,0,1,2,0,3
16771,CLCA1 ,3,1,0,0,0,4
16781,B4GALNT2 ,0,0,2,2,0,4
16799,LLGL2 ,0,0,4,1,0,5
16805,OPALIN ,0,1,0,4,0,5
16825,LTC4S ,2,0,0,1,0,3
16842,FCN2 ,3,0,1,0,0,4
16844,PIGR ,6,1,0,0,0,7
16858,PRKN ,0,0,3,2,0,5
16869,IFNAR1 ,0,1,3,1,0,5
16873,TRIM15 ,0,0,1,2,0,3
16894,NELFE ,6,0,1,0,0,7
16903,ULK1 ,0,0,1,2,0,3
16905,SDC4 ,0,1,2,0,0,3
16940,CYP17A1 ,3,1,0,0,0,4
16942,C4H8ORF82 ,1,0,1,0,0,2
16951,XPNPEP2 ,1,0,4,0,0,5
16958,SLC52A2 ,1,0,3,0,0,4
16968,TAC3 ,1,0,1,1,0,3
16981,PKM ,8,0,0,1,0,9
16991,STX1A ,2,0,0,1,0,3
16999,ZFY ,0,0,1,4,0,5
17007,LAMTOR4 ,0,0,3,1,0,4
17015,DRAM1 ,0,1,0,1,0,2
17016,PSME1 ,0,1,4,0,0,5
17025,UBXN1 ,4,0,0,1,0,5
17047,NRF1 ,0,0,1,6,0,7
17052,NPC1 ,0,1,2,0,0,3
17059,DRC7 ,0,0,2,1,0,3
17065,CYSTM1 ,1,0,1,0,0,2
17085,PDK4 ,0,1,2,0,0,3
17091,PPAT ,0,0,1,1,0,2
17094,ITK ,0,0,1,1,0,2
17108,CRYL1 ,4,1,0,0,0,5
17112,CBR2 ,1,0,0,1,0,2
17118,PLCL1 ,5,0,0,1,0,6
17126,DDHD2 ,1,0,0,1,0,2
17127,UBL5 ,0,1,0,1,0,2
17131,UGP2 ,3,1,0,0,0,4
17135,AKR1A1 ,1,0,3,0,0,4
17140,TANC1 ,2,0,0,1,0,3
17147,ABCC9 ,0,0,4,2,0,6
17155,CHM ,0,0,1,1,0,2
17161,SAG ,3,1,0,0,0,4
17184,TNF ,0,1,1,0,0,2
17187,CFTR ,0,1,8,1,0,10
17201,NCAPD3 ,0,1,0,3,0,4
17203,TSC22D3 ,1,0,5,1,0,7
17208,TRIM45 ,0,0,2,1,0,3
17214,PQBP1 ,0,1,0,1,0,2
17232,SLA-DRB1 ,4,0,0,1,0,5
17252,EIF4A3 ,0,1,1,1,0,3
17272,MAL2 ,1,0,0,1,0,2
17277,MYC ,1,0,0,3,0,4
17282,TRIM50 ,0,1,0,1,0,2
17283,DCT ,2,1,0,0,0,3
17303,NMNAT3 ,0,0,1,2,0,3
17316,PCMT1 ,1,0,3,0,0,4
17325,CLEC5A ,1,0,0,2,0,3
17329,PPP1R3F ,1,0,0,1,0,2
17337,LOX ,1,0,1,0,0,2
17339,TRIP13 ,0,1,2,0,0,3
17340,QARS1 ,0,1,1,0,0,2
17344,MAP4K3 ,0,0,5,1,0,6
17356,HBS1L ,5,0,0,1,0,6
17381,PGLYRP2 ,0,1,3,0,0,4
17386,BAG6 ,2,0,0,4,0,6
17387,GABARAPL2 ,4,0,0,1,0,5
17390,PITPNM3 ,4,0,0,4,0,8
17391,VNN1 ,1,0,1,0,0,2
17412,MRPL27 ,1,0,3,1,0,5
17420,PLCD4 ,2,1,0,0,0,3
17424,LOC100624788 ,3,0,1,0,0,4
17429,PMEL ,3,0,0,1,0,4
17430,AKAP10 ,0,1,0,5,0,6
17437,SLCO2B1 ,3,0,1,0,0,4
17444,EGF ,1,0,0,5,0,6
17451,RCL1 ,0,0,3,1,0,4
17453,CXCL8 ,1,0,1,0,0,2
17454,SNX19 ,0,0,1,5,0,6
17460,GTF2A1L ,0,0,2,1,0,3
17461,ITGB6 ,0,1,3,0,0,4
17493,EDN3 ,0,1,2,0,0,3
17504,RAB3A ,0,1,1,2,0,4
17506,ELAC2 ,3,0,1,0,0,4
17528,F5 ,2,1,0,0,0,3
17549,RNASE6 ,1,0,3,0,0,4
17565,MSH4 ,4,0,1,0,0,5
17579,SYNGR3 ,1,0,2,1,0,4
17581,EPOR ,0,1,1,0,0,2
17585,UGCG ,0,1,1,0,0,2
17589,OCIAD2 ,4,0,0,1,0,5
17598,PNN ,4,0,0,1,0,5
17602,CXCL16 ,0,1,0,3,0,4
17616,INPP5B ,0,0,2,1,0,3
17656,SLC10A7 ,0,1,6,1,0,8
17663,APOA1 ,1,0,2,0,0,3
17665,THRA ,0,1,3,0,0,4
17676,CHST15 ,0,0,1,2,0,3
17686,MPV17 ,0,0,5,1,0,6
17703,CCS ,0,1,1,1,0,3
17713,SCAMP5 ,4,0,1,0,0,5
17721,VDR ,0,1,1,0,0,2
17726,YIF1B ,2,0,1,0,0,3
17735,PLAT ,0,1,2,0,0,3
17740,NFIB ,0,0,6,1,0,7
17763,ATP5PF ,1,0,2,0,0,3
17764,HIKESHI ,1,0,1,0,0,2
17768,TSHB ,1,0,1,0,0,2
17775,IL2RA ,0,1,0,2,0,3
17797,ENG ,1,0,0,1,0,2
17804,ITGB2 ,4,1,0,0,0,5
17824,IRF1 ,0,1,1,1,0,3
17831,ATG16L1 ,0,0,4,1,0,5
17833,CAST ,4,0,2,0,0,6
17841,RPS23 ,1,0,2,0,0,3
17842,CD163 ,1,0,0,7,0,8
17844,STARD3NL ,0,1,1,0,0,2
17852,CDK5RAP1 ,3,0,1,1,0,5
17857,IVNS1ABP ,3,0,0,1,0,4
17881,TCF3 ,0,2,0,6,0,8
17897,EMR4 ,0,1,0,4,0,5
17908,ACVR2B ,0,1,4,0,0,5
17911,ATP2B1 ,5,1,1,0,0,7
17917,ANXA2 ,6,0,1,0,0,7
17918,BCL6 ,0,1,0,1,0,2
17924,AGPAT4 ,0,1,1,3,0,5
17932,TRIM2 ,3,0,0,1,0,4
17933,KLF9 ,0,1,0,1,0,2
17969,CXCR5 ,0,1,1,0,0,2
17980,SFTPC ,1,0,0,2,0,3
17987,GPCPD1 ,0,0,1,1,0,2
17988,SAA2 ,3,0,3,0,0,6
17989,SLC44A2 ,4,0,2,0,0,6
17992,TBCE ,6,0,1,0,0,7
18009,VIPR1 ,0,2,4,0,0,6
18011,KDM5A ,0,0,4,1,0,5
18015,IPPK ,0,0,2,1,0,3
